"aa" = (/turf/MidgarTiles/MidgarRoofWest,/area)
"ab" = (/turf/MidgarTiles/MidgarLightWall3,/area)
"ac" = (/turf/MidgarTiles/MidgarRoofEast,/area)
"ad" = (/turf/MidgarTiles/MidgarWall4,/area)
"ae" = (/turf/Waters/Water8,/area)
"af" = (/turf/Roof6R,/area)
"ag" = (/obj/Turfs/Edges/DarkEdgeW,/obj/Turfs/Edges/DarkEdgeN,/turf/MidgarTiles/MidgarLightWall3,/area)
"ah" = (/obj/Turfs/Edges/DarkEdgeN,/turf/MidgarTiles/MidgarLightWall3,/area)
"ai" = (/obj/Turfs/Edges/DarkEdgeE,/obj/Turfs/Edges/DarkEdgeN,/turf/MidgarTiles/MidgarLightWall3,/area)
"aj" = (/turf/MidgarTiles/MidgarTile1,/area)
"ak" = (/turf/Waters/Water8,/turf/MidgarTiles/MidgarGrate3,/area)
"al" = (/turf/MidgarTiles/MidgarRapeWindow,/area)
"am" = (/obj/Turfs/Edges/MetalEdgeW,/obj/Turfs/Edges/MetalEdgeN,/turf/MidgarTiles/MidgarTile1,/area)
"an" = (/obj/Turfs/Edges/MetalEdgeN,/turf/MidgarTiles/MidgarTile1,/area)
"ao" = (/obj/Turfs/Edges/MetalEdgeE,/obj/Turfs/Edges/MetalEdgeN,/turf/MidgarTiles/MidgarTile1,/area)
"ap" = (/obj/Turfs/Edges/MetalEdgeW,/turf/MidgarTiles/MidgarTile1,/area)
"aq" = (/obj/Turfs/Edges/MetalEdgeE,/turf/MidgarTiles/MidgarTile1,/area)
"ar" = (/turf/MidgarTiles/MidgarTile1,/turf/MidgarTiles/MidgarGrate3,/area)
"as" = (/obj/Turfs/Edges/DarkEdgeN,/obj/Turfs/Edges/MetalEdgeE,/turf/MidgarTiles/MidgarLightWall3,/area)
"at" = (/turf/MidgarTiles/MidgarLightWall3,/obj/Turfs/Edges/MetalEdgeW,/turf/MidgarTiles/MidgarGrate3,/area)
"au" = (/turf/MidgarTiles/MidgarLightWall3,/obj/Turfs/Edges/MetalEdgeE,/turf/MidgarTiles/MidgarGrate3,/area)
"av" = (/obj/Turfs/Edges/DarkEdgeE,/obj/Turfs/Edges/DarkEdgeN,/obj/Turfs/Edges/MetalEdgeW,/turf/MidgarTiles/MidgarLightWall3,/area)
"aw" = (/obj/Turfs/MidgarObj/MidgarLaser2,/turf/MidgarTiles/MidgarTile1,/area)
"ax" = (/obj/Turfs/MidgarObj/MidgarLaser4,/turf/MidgarTiles/MidgarTile1,/area)
"ay" = (/obj/Turfs/Edges/DarkEdgeW,/turf/MidgarTiles/MidgarWall4,/area)
"az" = (/obj/Turfs/Edges/MetalEdgeE,/turf/MidgarTiles/MidgarWall4,/area)
"aA" = (/turf/MidgarTiles/MidgarWall4,/obj/Turfs/Edges/MetalEdgeW,/turf/MidgarTiles/MidgarGrate3,/area)
"aB" = (/turf/MidgarTiles/MidgarWall4,/obj/Turfs/Edges/MetalEdgeE,/turf/MidgarTiles/MidgarGrate3,/area)
"aC" = (/obj/Turfs/Edges/MetalEdgeW,/obj/Turfs/Edges/DarkEdgeE,/turf/MidgarTiles/MidgarWall4,/area)
"aD" = (/obj/Turfs/Edges/MetalEdgeE,/turf/Waters/Water8,/area)
"aE" = (/turf/Waters/Water8,/obj/Turfs/Edges/MetalEdgeW,/turf/MidgarTiles/MidgarGrate3,/area)
"aF" = (/turf/Waters/Water8,/obj/Turfs/Edges/MetalEdgeE,/turf/MidgarTiles/MidgarGrate3,/area)
"aG" = (/obj/Turfs/Edges/MetalEdgeW,/turf/Waters/Water8,/area)
"aH" = (/obj/Turfs/Edges/DarkEdgeN,/obj/Turfs/Edges/MetalEdgeW,/turf/MidgarTiles/MidgarLightWall3,/area)
"aI" = (/obj/Turfs/Edges/MetalEdgeW,/turf/MidgarTiles/MidgarWall4,/area)
"aJ" = (/obj/Turfs/Edges/DarkEdgeE,/turf/MidgarTiles/MidgarWall4,/area)
"aK" = (/obj/Turfs/Edges/DarkEdgeW,/obj/Turfs/Edges/DarkEdgeN,/obj/Turfs/Edges/MetalEdgeE,/turf/MidgarTiles/MidgarLightWall3,/area)
"aL" = (/obj/Turfs/Edges/MetalEdgeE,/obj/Turfs/Edges/DarkEdgeW,/turf/MidgarTiles/MidgarWall4,/area)
"aM" = (/turf/MidgarTiles/MidgarRoofSouth,/area)
"aN" = (/turf/MidgarTiles/MidgarRoofSW,/area)
"aO" = (/turf/MidgarTiles/MidgarRoofSE,/area)
"aP" = (/turf/MidgarTiles/MidgarRoofNorth,/area)
"aQ" = (/turf/MidgarTiles/MidgarRoofNW,/area)
"aR" = (/turf/MidgarTiles/MidgarRoofNE,/area)
"aS" = (/obj/Turfs/MidgarObj/MidgarLaser5,/turf/MidgarTiles/MidgarTile1,/area)
"aT" = (/obj/Turfs/MidgarObj/MidgarBarrel,/turf/MidgarTiles/MidgarTile1,/area)
"aU" = (/turf/MidgarTiles/MidgarTile4,/area)
"aV" = (/turf/MidgarTiles/MidgarTile2,/area)
"aW" = (/turf/MidgarTiles/MidgarTile3,/area)
"aX" = (/turf/MidgarTiles/MidgarGrate,/area)
"aY" = (/obj/Turfs/Edges/MetalEdgeW,/obj/Special/Teleporter2{gotoX = 205; gotoY = 299; gotoZ = 1},/turf/MidgarTiles/MidgarTile1,/area)
"aZ" = (/obj/Special/Teleporter2{gotoX = 206; gotoY = 299; gotoZ = 1},/turf/MidgarTiles/MidgarTile1,/area)
"ba" = (/obj/Turfs/Edges/MetalEdgeW,/obj/Special/Teleporter2{gotoX = 408; gotoY = 299; gotoZ = 1},/turf/MidgarTiles/MidgarTile1,/area)
"bb" = (/obj/Special/Teleporter2{gotoX = "409"; gotoY = "299"; gotoZ = "1"},/turf/MidgarTiles/MidgarTile1,/area)
"bc" = (/obj/Turfs/Edges/MetalEdgeW,/obj/Special/Teleporter2{gotoX = 205; gotoY = "81"; gotoZ = 1},/turf/MidgarTiles/MidgarTile1,/area)
"bd" = (/obj/Special/Teleporter2{gotoX = 206; gotoY = 81; gotoZ = 1},/turf/MidgarTiles/MidgarTile1,/area)
"be" = (/obj/Turfs/Edges/MetalEdgeW,/obj/Special/Teleporter2{gotoX = 408; gotoY = 81; gotoZ = 1},/turf/MidgarTiles/MidgarTile1,/area)
"bf" = (/obj/Special/Teleporter2{gotoX = 409; gotoY = 81; gotoZ = 1},/turf/MidgarTiles/MidgarTile1,/area)

(1,1,1) = {"
aaabababababababababababababababababababababababababababababababababababababababababababababababababababababacaaabababababababababababababababababababababababababababababababababababababababababababababababababababababac
aaadadadadadadadadadadadadadadadadadadadadadadadadadadadadadadadadadadadadadadadadadadadadadadadadadadadadadacaaadadadadadadadadadadadadadadadadadadadadadadadadadadadadadadadadadadadadadadadadadadadadadadadadadadadadadac
aaaeaeaeaeaeaeaeaeaeaeaeaeaeaeaeaeaeaeaeaeaeaeaeaeaeaeaeaeaeaeaeaeaeaeaeaeaeaeaeaeaeaeaeaeaeaeaeaeaeaeaeaeaeacaaaeaeaeaeaeaeaeaeaeaeaeaeaeaeaeaeaeaeaeaeaeaeaeaeaeaeaeaeaeaeaeaeaeaeaeaeaeaeaeaeaeaeaeaeaeaeaeaeaeaeaeaeaeac
aaaeaeaeaeaeaeaeaeaeaeaeaeaeaeaeaeaeaeaeaeaeaeaeaeaeaeaeaeaeaeaeaeaeaeaeaeaeafafafafafafafafafafafafaeaeaeaeacaaaeaeaeaeaeaeaeaeaeaeaeaeaeaeaeaeaeaeaeaeaeaeaeaeaeaeaeaeaeaeaeaeaeaeaeaeaeafafafafafafafafafafafafaeaeaeaeac
aaaeaeaeaeaeaeaeaeaeaeaeaeaeaeaeaeaeaeaeaeaeaeaeaeaeaeaeaeaeaeaeaeaeaeaeaeaeafagahaiafafafafagahaiafaeaeaeaeacaaaeaeaeaeaeaeaeaeaeaeaeaeaeaeaeaeaeaeaeaeaeaeaeaeaeaeaeaeaeaeaeaeaeaeaeaeaeafagahaiafafafafagahaiafaeaeaeaeac
aaaeaeaeaeaeaeaeaeaeaeaeaeaeaeaeaeaeaeaeaeaeaeaeaeaeaeaeaeaeaeaeaeaeaeaeaeaeafajajajafafafafajajajafaeaeaeaeacaaaeaeaeaeaeaeaeaeaeaeaeaeaeaeaeaeaeaeaeaeaeaeaeaeaeaeaeaeaeaeaeaeaeaeaeaeaeafajajajafafafafajajajafaeaeaeaeac
aaaeaeaeaeaeaeaeaeaeaeaeaeaeaeaeaeaeaeaeaeaeaeaeaeaeaeaeaeaeaeaeaeaeaeaeaeaeafakakakalafafalakakakafaeaeaeaeacaaaeaeaeaeaeaeaeaeaeaeaeaeaeaeaeaeaeaeaeaeaeaeaeaeaeaeaeaeaeaeaeaeaeaeaeaeaeafakakakalafafalakakakafaeaeaeaeac
aaaeamananananananananananananananananananananananananananananaoaeaeaeaeaeaeafajajajajalalajajajajafaeaeaeaeacaaaeamananananananananananananananananananananananananananananaoaeaeaeaeaeaeafajajajajalalajajajajafaeaeaeaeac
aaaeapajajajajajajajajajajajajajajajajajajajajajajajajajajajajaqaeaeaeaeaeaeafajajajajajajajajajajafaeaeaeaeacaaaeapajajajajajajajajajajajajajajajajajajajajajajajajajajajajaqaeaeaeaeaeaeafajajajajajajajajajajafaeaeaeaeac
aaaeapajajajajajajajajajajajajajajajajajajajajajajajajajajararaqaeaeaeaeaeaeafafafafafajajafafafafafaeaeaeaeacaaaeapajajajajajajajajajajajajajajajajajajajajajajajajajajararaqaeaeaeaeaeaeafafafafafajajafafafafafaeaeaeaeac
aaaeapaqagahahahahahahahahahahahahahahahahahahahahahahahasatauavaeaeaeaeaeaeagahahahaiawaxagahahahaiaeaeaeaeacaaaeapaqagahahahahahahahahahahahahahahahahahahahahahahahasatauavaeaeaeaeaeaeagahahahaiawaxagahahahaiaeaeaeaeac
aaaeapaqayadadadadadadadadadadadadadadadadadadadadadadadazaAaBaCaeaeaeaeaeaeapajajajajajajajajajajaqaeaeaeaeacaaaeapaqayadadadadadadadadadadadadadadadadadadadadadadadazaAaBaCaeaeaeaeaeaeapajajajajajajajajajajaqaeaeaeaeac
aaaeapaqaeaeaeaeaeaeaeaeaeaeaeaeaeaeaeaeaeaeaeaeaeaeaeaeaDaEaFaGaeaeaeaeaeaeapajajajajajajajajajajaqaeaeaeaeacaaaeapaqaeaeaeaeaeaeaeaeaeaeaeaeaeaeaeaeaeaeaeaeaeaeaeaeaDaEaFaGaeaeaeaeaeaeapajajajajajajajajajajaqaeaeaeaeac
aaaeapaqaeaeaeaeaeaeaeaeaeaeaeaeaeaeaeaeaeaeaeaeaeaeaeaeaDaEaFaGaeaeaeaeaeaeapajajajajajajajajajajaqaeaeaeaeacaaaeapaqaeaeaeaeaeaeaeaeaeaeaeaeaeaeaeaeaeaeaeaeaeaeaeaeaDaEaFaGaeaeaeaeaeaeapajajajajajajajajajajaqaeaeaeaeac
aaaeapaqaeaeaeaeaeaeaeaeaeaeaeaeaeaeaeaeaeaeaeaeaeaeaeaeaDaEaFaGaeaeaeaeaeaeapajajajajajajajajajajaqaeaeaeaeacaaaeapaqaeaeaeaeaeaeaeaeaeaeaeaeaeaeaeaeaeaeaeaeaeaeaeaeaDaEaFaGaeaeaeaeaeaeapajajajajajajajajajajaqaeaeaeaeac
aaaeapaqaeaeaeaeaeaeaeaeaeaeaeaeaeaeaeaeaeaeaeaeaeaeaeaeaDaEaFaGaeaeaeaeaeaeapajajajajararajajajajaqaeaeaeaeacaaaeapaqaeaeaeaeaeaeaeaeaeaeaeaeaeaeaeaeaeaeaeaeaeaeaeaeaDaEaFaGaeaeaeaeaeaeapajajajajararajajajajaqaeaeaeaeac
aaaeapaqaeaeamananananananananananananananananaoaeaeaeaeaDaEaFaGaeaeaeaeaeaeagahahahasatauaHahahahaiaeaeaeaeacaaaeapaqaeaeamananananananananananananananananaoaeaeaeaeaDaEaFaGaeaeaeaeaeaeagahahahasatauaHahahahaiaeaeaeaeac
aaaeapaqaeaeapararajajajajajajajajajajajajajajaqaeaeaeaeaDaEaFaGaeaeaeaeaeaeayadadadazaAaBaIadadadaJaeaeaeaeacaaaeapaqaeaeapararajajajajajajajajajajajajajajaqaeaeaeaeaDaEaFaGaeaeaeaeaeaeayadadadazaAaBaIadadadaJaeaeaeaeac
aaaeapaqaeaeaKatauaHahahahahahahahahahaiapajajaqaeaeaeaeaDaEaFaGaeaeaeaeaeaeaeaeaeaeaDaEaFaGaeaeaeaeaeaeaeaeacaaaeapaqaeaeaKatauaHahahahahahahahahahaiapajajaqaeaeaeaeaDaEaFaGaeaeaeaeaeaeaeaeaeaeaDaEaFaGaeaeaeaeaeaeaeaeac
aaaeapaqaeaeaLaAaBaIadadadadadadadadadaJapajajaqaeaeaeaeaDaEaFaGaeaeaeaeaeaeaeaeaeaeaDaEaFaGaeaeaeaeaeaeaeaeacaaaeapaqaeaeaLaAaBaIadadadadadadadadadaJapajajaqaeaeaeaeaDaEaFaGaeaeaeaeaeaeaeaeaeaeaDaEaFaGaeaeaeaeaeaeaeaeac
aaaeapaqaeaeaDaEaFaGaeaeaeaeaeaeaeaeaeaeapajajaqaeaeaeaeaDaEaFaGaeaeaeaeaeaeaeaeaeaeaDaEaFaGaeaeaeaeaeaeaeaeacaaaeapaqaeaeaDaEaFaGaeaeaeaeaeaeaeaeaeaeapajajaqaeaeaeaeaDaEaFaGaeaeaeaeaeaeaeaeaeaeaDaEaFaGaeaeaeaeaeaeaeaeac
aaaeapaqaeaeaDaEaFaGaeaeaeaeaeaeaeaeaeaeapajajaqaeaeaeaeaDaEaFaGaeaeaeaeaeaeaeaeaeaeaDaEaFaGaeaeaeaeaeaeaeaeacaaaeapaqaeaeaDaEaFaGaeaeaeaeaeaeaeaeaeaeapajajaqaeaeaeaeaDaEaFaGaeaeaeaeaeaeaeaeaeaeaDaEaFaGaeaeaeaeaeaeaeaeac
aaaeapajanananararaoaeaeaeaeaeaeaeaeaeaeapajajaqaeaeaeaeamararananananananananananananararananananaoaeaeaeaeacaaaeapajanananararaoaeaeaeaeaeaeaeaeaeaeapajajaqaeaeaeaeamararananananananananananananararananananaoaeaeaeaeac
aaaeapajajajajajajaqaeaeaeaeaeaeaeaeaeaeapajajaqaeaeaeaeapajajajajajajajajajajajajajajajajajajajajaqaeaeaeaeacaaaeapajajajajajajaqaeaeaeaeaeaeaeaeaeaeapajajaqaeaeaeaeapajajajajajajajajajajajajajajajajajajajajaqaeaeaeaeac
aaaeagahahahahahahaiaeaeaeaeaeaeaeaeaeaeapajajaqaeaeaeaeagahahahahahahahahahahahahahahahahahahahahaiaeaeaeaeacaaaeagahahahahahahaiaeaeaeaeaeaeaeaeaeaeapajajaqaeaeaeaeagahahahahahahahahahahahahahahahahahahahahaiaeaeaeaeac
aaaeayadadadadadadaJaeaeaeaeaeaeaeaeaeaeapajajaqaeaeaeaeayadadadadadadadadadadadadadadadadadadadadaJaeaeaeaeacaaaeayadadadadadadaJaeaeaeaeaeaeaeaeaeaeapajajaqaeaeaeaeayadadadadadadadadadadadadadadadadadadadadaJaeaeaeaeac
aaaeaeaeaeaeaeaeaeaeaeaeaeaeaeaeaeaeaeaeapajajaqaeaeaeaeaeaeaeaeaeaeaeaeaeaeaeaeaeaeaeaeaeaeaeaeaeaeaeaeaeaeacaaaeaeaeaeaeaeaeaeaeaeaeaeaeaeaeaeaeaeaeapajajaqaeaeaeaeaeaeaeaeaeaeaeaeaeaeaeaeaeaeaeaeaeaeaeaeaeaeaeaeaeaeac
aaaMaMaMaMaMaMaMaMaMaMaMaMaMaMaMaMaMaMaNapajajaqaOaMaMaMaMaMaMaMaMaMaMaMaMaMaMaMaMaMaMaMaMaMaMaMaMaMaMaMaMaMacaaaMaMaMaMaMaMaMaMaMaMaMaMaMaMaMaMaMaMaNapajajaqaOaMaMaMaMaMaMaMaMaMaMaMaMaMaMaMaMaMaMaMaMaMaMaMaMaMaMaMaMaMac
aaaPaPaPaPaPaPaPaPaPaPaPaPaPaPaPaPaPaPaQajajajajaRaPaPaPaPaPaPaPaPaPaPaPaPaPaPaPaPaPaPaPaPaPaPaPaPaPaPaPaPaPacaaaPaPaPaPaPaPaPaPaPaPaPaPaPaPaPaPaPaPaQajajajajaRaPaPaPaPaPaPaPaPaPaPaPaPaPaPaPaPaPaPaPaPaPaPaPaPaPaPaPaPaPac
aaagahahahahahahahahahahahahahahahahahaiawaSaSaxagahahahahahahahahahahahahahahahahahahahahahahahahahahahahaiacaaagahahahahahahahahahahahahahahahahahaiawaSaSaxagahahahahahahahahahahahahahahahahahahahahahahahahahahahahaiac
aaaTaTaTajajajajajajajaUaVaWajajajaUaVaWajajajajaUaVaWajajajaUaVaWajajajaUaVaWajajajaUaVaWajajajajajajajajajacaaaTaTaTajajajajajajajaUaVaWajajajaUaVaWajajajajaUaVaWajajajaUaVaWajajajaUaVaWajajajaUaVaWajajajajajajajajajac
aaaTaTajajajajajajajajaUaVaWajajajaUaVaWajajajajaUaVaWajajajaUaVaWajajajaUaVaWajajajaUaVaWajajajajajajajajajacaaaTaTajajajajajajajajaUaVaWajajajaUaVaWajajajajaUaVaWajajajaUaVaWajajajaUaVaWajajajaUaVaWajajajajajajajajajac
aaaTajajajajajajajajajaUaVaWajajajaUaVaWajajajajaUaVaWajajajaUaVaWajajajaUaVaWajajajaUaVaWajajajajajajajajajacaaaTajajajajajajajajajaUaVaWajajajaUaVaWajajajajaUaVaWajajajaUaVaWajajajaUaVaWajajajaUaVaWajajajajajajajajajac
aaajajajajajajajajajajaUaVaWajajajaUaVaWajajajajaUaVaWajajajaUaVaWajajajaUaVaWajajajaUaVaWajajajajajajajajajacaaajajajajajajajajajajaUaVaWajajajaUaVaWajajajajaUaVaWajajajaUaVaWajajajaUaVaWajajajaUaVaWajajajajajajajajajac
aaajajajajajajajajajajaUaVaWajajajaUaVaWajajajajaUaVaWajajajaUaVaWajajajaUaVaWajajajaUaVaWajajajajajajajajajacaaajajajajajajajajajajaUaVaWajajajaUaVaWajajajajaUaVaWajajajaUaVaWajajajaUaVaWajajajaUaVaWajajajajajajajajajac
aaagahahahahahahahahahahahahahahahahahahahahahahahahahahahahahahahahahahahahahahahahahahahahahahahahaiapajajacaaagahahahahahahahahahahahahahahahahahahahahahahahahahahahahahahahahahahahahahahahahahahahahahahahahaiapajajac
aaaXaXaXaXaXaXaXaXaXaXaXaXaXaXaXaXaXaXaXaXaXaXaXaXaXaXaXaXaXaXaXaXaXaXaXaXaXaXaXaXaXaXaXaXaXaXaXaXaXaXapajajacaaaXaXaXaXaXaXaXaXaXaXaXaXaXaXaXaXaXaXaXaXaXaXaXaXaXaXaXaXaXaXaXaXaXaXaXaXaXaXaXaXaXaXaXaXaXaXaXaXaXaXapajajac
aaaMaMaMaMaMaMaMaMaMaMaMaMaMaMaMaMaMaMaNaXaXaXaXaXaXaXaXaXaXaXaXaXaXaXaXaXaOaMaMaMaMaMaMaMaMaMaMaMaMaNaYaZaOaMaaaMaMaMaMaMaMaMaMaMaMaMaMaMaMaMaMaMaMaNaXaXaXaXaXaXaXaXaXaXaXaXaXaXaXaXaXaOaMaMaMaMaMaMaMaMaMaMaMaMaNbabbaOaM
aMaMaMaMaMaMaMaMaMaMaMaMaMaMaMaMaMaMaMaMaMaMaMaMaMaMaMaMaMaMaMaMaMaMaMaMaMaMaMaMaMaMaMaMaMaMaMaMaMaMaMaMaMaMaMaMaMaMaMaMaMaMaMaMaMaMaMaMaMaMaMaMaMaMaMaMaMaMaMaMaMaMaMaMaMaMaMaMaMaMaMaMaMaMaMaMaMaMaMaMaMaMaMaMaMaMaMaMaMaM
aPaPaPaPaPaPaPaPaPaPaPaPaPaPaPaPaPaPaPaPaPaPaPaPaPaPaPaPaPaPaPaPaPaPaPaPaPaPaPaPaPaPaPaPaPaPaPaPaPaPaPaPaPaPaPaPaPaPaPaPaPaPaPaPaPaPaPaPaPaPaPaPaPaPaPaPaPaPaPaPaPaPaPaPaPaPaPaPaPaPaPaPaPaPaPaPaPaPaPaPaPaPaPaPaPaPaPaPaPaP
aaabababababababababababababababababababababababababababababababababababababababababababababababababababababacaaabababababababababababababababababababababababababababababababababababababababababababababababababababababac
aaadadadadadadadadadadadadadadadadadadadadadadadadadadadadadadadadadadadadadadadadadadadadadadadadadadadadadacaaadadadadadadadadadadadadadadadadadadadadadadadadadadadadadadadadadadadadadadadadadadadadadadadadadadadadadac
aaaeaeaeaeaeaeaeaeaeaeaeaeaeaeaeaeaeaeaeaeaeaeaeaeaeaeaeaeaeaeaeaeaeaeaeaeaeaeaeaeaeaeaeaeaeaeaeaeaeaeaeaeaeacaaaeaeaeaeaeaeaeaeaeaeaeaeaeaeaeaeaeaeaeaeaeaeaeaeaeaeaeaeaeaeaeaeaeaeaeaeaeaeaeaeaeaeaeaeaeaeaeaeaeaeaeaeaeac
aaaeaeaeaeaeaeaeaeaeaeaeaeaeaeaeaeaeaeaeaeaeaeaeaeaeaeaeaeaeaeaeaeaeaeaeaeaeafafafafafafafafafafafafaeaeaeaeacaaaeaeaeaeaeaeaeaeaeaeaeaeaeaeaeaeaeaeaeaeaeaeaeaeaeaeaeaeaeaeaeaeaeaeaeaeaeafafafafafafafafafafafafaeaeaeaeac
aaaeaeaeaeaeaeaeaeaeaeaeaeaeaeaeaeaeaeaeaeaeaeaeaeaeaeaeaeaeaeaeaeaeaeaeaeaeafagahaiafafafafagahaiafaeaeaeaeacaaaeaeaeaeaeaeaeaeaeaeaeaeaeaeaeaeaeaeaeaeaeaeaeaeaeaeaeaeaeaeaeaeaeaeaeaeaeafagahaiafafafafagahaiafaeaeaeaeac
aaaeaeaeaeaeaeaeaeaeaeaeaeaeaeaeaeaeaeaeaeaeaeaeaeaeaeaeaeaeaeaeaeaeaeaeaeaeafajajajafafafafajajajafaeaeaeaeacaaaeaeaeaeaeaeaeaeaeaeaeaeaeaeaeaeaeaeaeaeaeaeaeaeaeaeaeaeaeaeaeaeaeaeaeaeaeafajajajafafafafajajajafaeaeaeaeac
aaaeaeaeaeaeaeaeaeaeaeaeaeaeaeaeaeaeaeaeaeaeaeaeaeaeaeaeaeaeaeaeaeaeaeaeaeaeafakakakalafafalakakakafaeaeaeaeacaaaeaeaeaeaeaeaeaeaeaeaeaeaeaeaeaeaeaeaeaeaeaeaeaeaeaeaeaeaeaeaeaeaeaeaeaeaeafakakakalafafalakakakafaeaeaeaeac
aaaeamananananananananananananananananananananananananananananaoaeaeaeaeaeaeafajajajajalalajajajajafaeaeaeaeacaaaeamananananananananananananananananananananananananananananaoaeaeaeaeaeaeafajajajajalalajajajajafaeaeaeaeac
aaaeapajajajajajajajajajajajajajajajajajajajajajajajajajajajajaqaeaeaeaeaeaeafajajajajajajajajajajafaeaeaeaeacaaaeapajajajajajajajajajajajajajajajajajajajajajajajajajajajajaqaeaeaeaeaeaeafajajajajajajajajajajafaeaeaeaeac
aaaeapajajajajajajajajajajajajajajajajajajajajajajajajajajararaqaeaeaeaeaeaeafafafafafajajafafafafafaeaeaeaeacaaaeapajajajajajajajajajajajajajajajajajajajajajajajajajajararaqaeaeaeaeaeaeafafafafafajajafafafafafaeaeaeaeac
aaaeapaqagahahahahahahahahahahahahahahahahahahahahahahahasatauavaeaeaeaeaeaeagahahahaiawaxagahahahaiaeaeaeaeacaaaeapaqagahahahahahahahahahahahahahahahahahahahahahahahasatauavaeaeaeaeaeaeagahahahaiawaxagahahahaiaeaeaeaeac
aaaeapaqayadadadadadadadadadadadadadadadadadadadadadadadazaAaBaCaeaeaeaeaeaeapajajajajajajajajajajaqaeaeaeaeacaaaeapaqayadadadadadadadadadadadadadadadadadadadadadadadazaAaBaCaeaeaeaeaeaeapajajajajajajajajajajaqaeaeaeaeac
aaaeapaqaeaeaeaeaeaeaeaeaeaeaeaeaeaeaeaeaeaeaeaeaeaeaeaeaDaEaFaGaeaeaeaeaeaeapajajajajajajajajajajaqaeaeaeaeacaaaeapaqaeaeaeaeaeaeaeaeaeaeaeaeaeaeaeaeaeaeaeaeaeaeaeaeaDaEaFaGaeaeaeaeaeaeapajajajajajajajajajajaqaeaeaeaeac
aaaeapaqaeaeaeaeaeaeaeaeaeaeaeaeaeaeaeaeaeaeaeaeaeaeaeaeaDaEaFaGaeaeaeaeaeaeapajajajajajajajajajajaqaeaeaeaeacaaaeapaqaeaeaeaeaeaeaeaeaeaeaeaeaeaeaeaeaeaeaeaeaeaeaeaeaDaEaFaGaeaeaeaeaeaeapajajajajajajajajajajaqaeaeaeaeac
aaaeapaqaeaeaeaeaeaeaeaeaeaeaeaeaeaeaeaeaeaeaeaeaeaeaeaeaDaEaFaGaeaeaeaeaeaeapajajajajajajajajajajaqaeaeaeaeacaaaeapaqaeaeaeaeaeaeaeaeaeaeaeaeaeaeaeaeaeaeaeaeaeaeaeaeaDaEaFaGaeaeaeaeaeaeapajajajajajajajajajajaqaeaeaeaeac
aaaeapaqaeaeaeaeaeaeaeaeaeaeaeaeaeaeaeaeaeaeaeaeaeaeaeaeaDaEaFaGaeaeaeaeaeaeapajajajajararajajajajaqaeaeaeaeacaaaeapaqaeaeaeaeaeaeaeaeaeaeaeaeaeaeaeaeaeaeaeaeaeaeaeaeaDaEaFaGaeaeaeaeaeaeapajajajajararajajajajaqaeaeaeaeac
aaaeapaqaeaeamananananananananananananananananaoaeaeaeaeaDaEaFaGaeaeaeaeaeaeagahahahasatauaHahahahaiaeaeaeaeacaaaeapaqaeaeamananananananananananananananananaoaeaeaeaeaDaEaFaGaeaeaeaeaeaeagahahahasatauaHahahahaiaeaeaeaeac
aaaeapaqaeaeapararajajajajajajajajajajajajajajaqaeaeaeaeaDaEaFaGaeaeaeaeaeaeayadadadazaAaBaIadadadaJaeaeaeaeacaaaeapaqaeaeapararajajajajajajajajajajajajajajaqaeaeaeaeaDaEaFaGaeaeaeaeaeaeayadadadazaAaBaIadadadaJaeaeaeaeac
aaaeapaqaeaeaKatauaHahahahahahahahahahaiapajajaqaeaeaeaeaDaEaFaGaeaeaeaeaeaeaeaeaeaeaDaEaFaGaeaeaeaeaeaeaeaeacaaaeapaqaeaeaKatauaHahahahahahahahahahaiapajajaqaeaeaeaeaDaEaFaGaeaeaeaeaeaeaeaeaeaeaDaEaFaGaeaeaeaeaeaeaeaeac
aaaeapaqaeaeaLaAaBaIadadadadadadadadadaJapajajaqaeaeaeaeaDaEaFaGaeaeaeaeaeaeaeaeaeaeaDaEaFaGaeaeaeaeaeaeaeaeacaaaeapaqaeaeaLaAaBaIadadadadadadadadadaJapajajaqaeaeaeaeaDaEaFaGaeaeaeaeaeaeaeaeaeaeaDaEaFaGaeaeaeaeaeaeaeaeac
aaaeapaqaeaeaDaEaFaGaeaeaeaeaeaeaeaeaeaeapajajaqaeaeaeaeaDaEaFaGaeaeaeaeaeaeaeaeaeaeaDaEaFaGaeaeaeaeaeaeaeaeacaaaeapaqaeaeaDaEaFaGaeaeaeaeaeaeaeaeaeaeapajajaqaeaeaeaeaDaEaFaGaeaeaeaeaeaeaeaeaeaeaDaEaFaGaeaeaeaeaeaeaeaeac
aaaeapaqaeaeaDaEaFaGaeaeaeaeaeaeaeaeaeaeapajajaqaeaeaeaeaDaEaFaGaeaeaeaeaeaeaeaeaeaeaDaEaFaGaeaeaeaeaeaeaeaeacaaaeapaqaeaeaDaEaFaGaeaeaeaeaeaeaeaeaeaeapajajaqaeaeaeaeaDaEaFaGaeaeaeaeaeaeaeaeaeaeaDaEaFaGaeaeaeaeaeaeaeaeac
aaaeapajanananararaoaeaeaeaeaeaeaeaeaeaeapajajaqaeaeaeaeamararananananananananananananararananananaoaeaeaeaeacaaaeapajanananararaoaeaeaeaeaeaeaeaeaeaeapajajaqaeaeaeaeamararananananananananananananararananananaoaeaeaeaeac
aaaeapajajajajajajaqaeaeaeaeaeaeaeaeaeaeapajajaqaeaeaeaeapajajajajajajajajajajajajajajajajajajajajaqaeaeaeaeacaaaeapajajajajajajaqaeaeaeaeaeaeaeaeaeaeapajajaqaeaeaeaeapajajajajajajajajajajajajajajajajajajajajaqaeaeaeaeac
aaaeagahahahahahahaiaeaeaeaeaeaeaeaeaeaeapajajaqaeaeaeaeagahahahahahahahahahahahahahahahahahahahahaiaeaeaeaeacaaaeagahahahahahahaiaeaeaeaeaeaeaeaeaeaeapajajaqaeaeaeaeagahahahahahahahahahahahahahahahahahahahahaiaeaeaeaeac
aaaeayadadadadadadaJaeaeaeaeaeaeaeaeaeaeapajajaqaeaeaeaeayadadadadadadadadadadadadadadadadadadadadaJaeaeaeaeacaaaeayadadadadadadaJaeaeaeaeaeaeaeaeaeaeapajajaqaeaeaeaeayadadadadadadadadadadadadadadadadadadadadaJaeaeaeaeac
aaaeaeaeaeaeaeaeaeaeaeaeaeaeaeaeaeaeaeaeapajajaqaeaeaeaeaeaeaeaeaeaeaeaeaeaeaeaeaeaeaeaeaeaeaeaeaeaeaeaeaeaeacaaaeaeaeaeaeaeaeaeaeaeaeaeaeaeaeaeaeaeaeapajajaqaeaeaeaeaeaeaeaeaeaeaeaeaeaeaeaeaeaeaeaeaeaeaeaeaeaeaeaeaeaeac
aaaMaMaMaMaMaMaMaMaMaMaMaMaMaMaMaMaMaMaNapajajaqaOaMaMaMaMaMaMaMaMaMaMaMaMaMaMaMaMaMaMaMaMaMaMaMaMaMaMaMaMaMacaaaMaMaMaMaMaMaMaMaMaMaMaMaMaMaMaMaMaMaNapajajaqaOaMaMaMaMaMaMaMaMaMaMaMaMaMaMaMaMaMaMaMaMaMaMaMaMaMaMaMaMaMac
aaaPaPaPaPaPaPaPaPaPaPaPaPaPaPaPaPaPaPaQajajajajaRaPaPaPaPaPaPaPaPaPaPaPaPaPaPaPaPaPaPaPaPaPaPaPaPaPaPaPaPaPacaaaPaPaPaPaPaPaPaPaPaPaPaPaPaPaPaPaPaPaQajajajajaRaPaPaPaPaPaPaPaPaPaPaPaPaPaPaPaPaPaPaPaPaPaPaPaPaPaPaPaPaPac
aaagahahahahahahahahahahahahahahahahahaiawaSaSaxagahahahahahahahahahahahahahahahahahahahahahahahahahahahahaiacaaagahahahahahahahahahahahahahahahahahaiawaSaSaxagahahahahahahahahahahahahahahahahahahahahahahahahahahahahaiac
aaaTaTaTajajajajajajajaUaVaWajajajaUaVaWajajajajaUaVaWajajajaUaVaWajajajaUaVaWajajajaUaVaWajajajajajajajajajacaaaTaTaTajajajajajajajaUaVaWajajajaUaVaWajajajajaUaVaWajajajaUaVaWajajajaUaVaWajajajaUaVaWajajajajajajajajajac
aaaTaTajajajajajajajajaUaVaWajajajaUaVaWajajajajaUaVaWajajajaUaVaWajajajaUaVaWajajajaUaVaWajajajajajajajajajacaaaTaTajajajajajajajajaUaVaWajajajaUaVaWajajajajaUaVaWajajajaUaVaWajajajaUaVaWajajajaUaVaWajajajajajajajajajac
aaaTajajajajajajajajajaUaVaWajajajaUaVaWajajajajaUaVaWajajajaUaVaWajajajaUaVaWajajajaUaVaWajajajajajajajajajacaaaTajajajajajajajajajaUaVaWajajajaUaVaWajajajajaUaVaWajajajaUaVaWajajajaUaVaWajajajaUaVaWajajajajajajajajajac
aaajajajajajajajajajajaUaVaWajajajaUaVaWajajajajaUaVaWajajajaUaVaWajajajaUaVaWajajajaUaVaWajajajajajajajajajacaaajajajajajajajajajajaUaVaWajajajaUaVaWajajajajaUaVaWajajajaUaVaWajajajaUaVaWajajajaUaVaWajajajajajajajajajac
aaajajajajajajajajajajaUaVaWajajajaUaVaWajajajajaUaVaWajajajaUaVaWajajajaUaVaWajajajaUaVaWajajajajajajajajajacaaajajajajajajajajajajaUaVaWajajajaUaVaWajajajajaUaVaWajajajaUaVaWajajajaUaVaWajajajaUaVaWajajajajajajajajajac
aaagahahahahahahahahahahahahahahahahahahahahahahahahahahahahahahahahahahahahahahahahahahahahahahahahaiapajajacaaagahahahahahahahahahahahahahahahahahahahahahahahahahahahahahahahahahahahahahahahahahahahahahahahahaiapajajac
aaaXaXaXaXaXaXaXaXaXaXaXaXaXaXaXaXaXaXaXaXaXaXaXaXaXaXaXaXaXaXaXaXaXaXaXaXaXaXaXaXaXaXaXaXaXaXaXaXaXaXapajajacaaaXaXaXaXaXaXaXaXaXaXaXaXaXaXaXaXaXaXaXaXaXaXaXaXaXaXaXaXaXaXaXaXaXaXaXaXaXaXaXaXaXaXaXaXaXaXaXaXaXaXapajajac
aaaMaMaMaMaMaMaMaMaMaMaMaMaMaMaMaMaMaMaNaXaXaXaXaXaXaXaXaXaXaXaXaXaXaXaXaXaOaMaMaMaMaMaMaMaMaMaMaMaMaNbcbdaOaMaaaMaMaMaMaMaMaMaMaMaMaMaMaMaMaMaMaMaMaNaXaXaXaXaXaXaXaXaXaXaXaXaXaXaXaXaXaOaMaMaMaMaMaMaMaMaMaMaMaMaNbebfaOaM
aMaMaMaMaMaMaMaMaMaMaMaMaMaMaMaMaMaMaMaMaMaMaMaMaMaMaMaMaMaMaMaMaMaMaMaMaMaMaMaMaMaMaMaMaMaMaMaMaMaMaMaMaMaMaMaMaMaMaMaMaMaMaMaMaMaMaMaMaMaMaMaMaMaMaMaMaMaMaMaMaMaMaMaMaMaMaMaMaMaMaMaMaMaMaMaMaMaMaMaMaMaMaMaMaMaMaMaMaMaM
"}
