"aa" = (/turf/Sand3,/area)
"ab" = (/obj/Turfs/Edges/Edge4E,/turf/Sand3,/area)
"ac" = (/obj/Turfs/Trees/Palm,/turf/Sand3,/area)
"ad" = (/obj/Turfs/Edges/Edge4S,/turf/Waters/Water10,/area)
"ae" = (/turf/Roof7,/area)
"af" = (/obj/Turfs/Edges/Edge4S,/turf/Sand3,/area)
"ag" = (/obj/Turfs/Edges/MetalEdgeW,/obj/Turfs/Edges/MetalEdgeN,/turf/Wall21,/area)
"ah" = (/obj/Turfs/Edges/MetalEdgeN,/turf/Wall21,/area)
"ai" = (/obj/Turfs/Edges/MetalEdgeE,/obj/Turfs/Edges/MetalEdgeN,/turf/Wall21,/area)
"aj" = (/obj/Turfs/Edges/Edge4E,/obj/Turfs/Edges/Edge4S,/turf/Sand3,/area)
"ak" = (/obj/Turfs/IconsXLBig/Icon12,/turf/Carpet6,/area)
"al" = (/obj/Turfs/IconsXLBig/Icon13,/turf/Carpet6,/area)
"am" = (/obj/Turfs/IconsXLBig/Icon16,/turf/Carpet6,/area)
"an" = (/turf/Carpet6,/area)
"ao" = (/obj/Turfs/IconsXLBig/Icon19,/turf/Carpet6,/area)
"ap" = (/obj/Turfs/IconsXLBig/Icon20,/turf/Carpet6,/area)
"aq" = (/obj/Turfs/IconsXLBig/Icon21,/turf/Carpet6,/area)
"ar" = (/obj/Turfs/IconsXLBig/Icon4,/turf/Carpet6,/area)
"as" = (/turf/Stone9,/area)
"at" = (/turf/Tile23,/area)
"au" = (/obj/Turfs/IconsXLBig/Icon4,/turf/Tile23,/area)
"av" = (/turf/Waters/Water10,/area)
"aw" = (/obj/Turfs/Edges/MetalEdgeW,/obj/Turfs/Edges/MetalEdgeN,/obj/Turfs/IconsX/Icon9,/turf/Wall21,/area)
"ax" = (/obj/Turfs/Edges/MetalEdgeE,/obj/Turfs/Edges/MetalEdgeN,/obj/Turfs/IconsX/Icon27,/turf/Wall21,/area)
"ay" = (/obj/Turfs/IconsXLBig/Icon39,/turf/Tile23,/area)
"az" = (/obj/Turfs/Edges/MetalEdgeW,/obj/Turfs/Edges/MetalEdgeN,/obj/Turfs/IconsX/Icon58,/turf/Wall21,/area)
"aA" = (/obj/Turfs/Edges/MetalEdgeN,/obj/Turfs/IconsX/Icon58,/turf/Wall21,/area)
"aB" = (/obj/Turfs/Edges/MetalEdgeN,/obj/Turfs/IconsX/Icon59,/turf/Wall21,/area)
"aC" = (/obj/Turfs/Edges/MetalEdgeE,/obj/Turfs/Edges/MetalEdgeN,/obj/Turfs/IconsX/Icon8,/turf/Wall21,/area)
"aD" = (/obj/Turfs/Edges/MetalEdgeW,/obj/Turfs/Edges/MetalEdgeN,/obj/Turfs/IconsX/Icon27,/turf/Wall21,/area)
"aE" = (/obj/Turfs/Edges/MetalEdgeE,/obj/Turfs/Edges/MetalEdgeN,/obj/Turfs/IconsX/Icon9,/turf/Wall21,/area)
"aF" = (/turf/Wall13,/area)
"aG" = (/obj/Turfs/Table5,/obj/Turfs/IconsX/Icon40,/turf/Tile23,/area)
"aH" = (/obj/Turfs/Table3,/obj/Turfs/IconsX/Icon40,/turf/Tile23,/area)
"aI" = (/obj/Turfs/Table5,/obj/Turfs/IconsX/Icon61,/turf/Tile23,/area)
"aJ" = (/obj/Turfs/Table4,/obj/Turfs/IconsX/Icon61,/turf/Tile23,/area)
"aK" = (/obj/Turfs/Table4,/obj/Turfs/IconsX/Icon47,/turf/Tile23,/area)
"aL" = (/obj/Turfs/Table3,/obj/Turfs/IconsX/Icon60,/turf/Tile23,/area)
"aM" = (/obj/Turfs/Table5,/obj/Turfs/IconsX/Icon41,/turf/Tile23,/area)
"aN" = (/obj/Turfs/Table3,/obj/Turfs/IconsX/Icon41,/turf/Tile23,/area)
"aO" = (/obj/Turfs/Surf/Water10Surf,/turf/Wall13,/area)
"aP" = (/obj/Turfs/IconsX/Icon48,/turf/Tile23,/area)
"aQ" = (/obj/Turfs/IconsX/Icon51,/turf/Tile23,/area)
"aR" = (/obj/Turfs/Table5,/turf/Tile23,/area)
"aS" = (/obj/Turfs/Table4,/turf/Tile23,/area)
"aT" = (/obj/Turfs/Table3,/turf/Tile23,/area)
"aU" = (/obj/Turfs/IconsX/Icon49,/turf/Tile23,/area)
"aV" = (/obj/Turfs/IconsX/Icon50,/turf/Tile23,/area)
"aW" = (/turf/Stairs1,/area)
"aX" = (/obj/Turfs/bridgeS,/turf/Wall9,/area)
"aY" = (/obj/Turfs/bridgeW,/obj/Turfs/bridgeS,/turf/Wall9,/area)
"aZ" = (/obj/Turfs/Edges/MetalEdgeW,/turf/Wall21,/area)
"ba" = (/turf/Wall21,/area)
"bb" = (/obj/Turfs/Edges/MetalEdgeE,/turf/Wall21,/area)
"bc" = (/turf/Wall9,/area)
"bd" = (/obj/Turfs/bridgeW,/turf/Wall9,/area)
"be" = (/obj/Turfs/bridgeN,/turf/Wall9,/area)
"bf" = (/obj/Turfs/bridgeN,/obj/Turfs/bridgeW,/turf/Wall9,/area)
"bg" = (/obj/Turfs/bridgeW,/turf/Waters/Water10,/area)
"bh" = (/obj/Turfs/bridgeE,/turf/Waters/Water10,/area)
"bi" = (/obj/Turfs/bridgeW,/obj/Turfs/Surf/Water10Surf,/turf/Waters/Water10,/area)
"bj" = (/obj/Turfs/bridgeE,/obj/Turfs/Surf/Water10Surf,/turf/Waters/Water10,/area)
"bk" = (/obj/Turfs/Edges/Edge4W,/turf/Stairs1,/area)
"bl" = (/obj/Turfs/Edges/Edge4E,/turf/Stairs1,/area)
"bm" = (/obj/Turfs/Edges/Edge4S,/turf/Wall13,/area)
"bn" = (/obj/Turfs/Edges/Edge4W,/turf/Sand3,/area)
"bo" = (/obj/Turfs/Surf/Water10Surf,/turf/Sand3,/area)

(1,1,1) = {"
aaaaaaaaaaaaaaaaaaaaaaaaaaaaaaaaaaaaaaaaaaaaaaaaaaaaaaaaaaaaaaaaabavavavavavavavavavavavavavavavavavavavavavavavavavavavavavavavavavavavavavavavavavavavavavavavavavavavavavavavavavav
aaaaaaaaaaaaaaaaaaaaaaaaaaaaaaaaaaaaaaaaaaaaaaaaaaaaaaaaaaaaaaaaabavavavavavavavavavavavavavavavavavavavavavavavavavavavavavavavavavavavavavavavavavavavavavavavavavavavavavavavavavav
aaaaaaaaaaaaaaaaaaaaaaaaaaaaaaaaaaaaaaaaaaaaaaaaaaaaaaaaaaacaaaaabavavavavavavavavavavavavavavavavavavavavavavavavavavavavavavavavavavavavavavavavavavavavavavavavavavavavavavavavavav
aaaaaaaaaaaaaaaaaaaaaaaaaaaaaaaaaaaaaaaaaaaaaaaaaaaaaaaaaaaaaaaaabavavavavavavavavavavavavavavavavavavavavavavavavavavavavavavavavavavavavavavavavavavavavavavavavavavavavavavavavavav
aaaaaaaaaaaaaaaaaaaaaaaaaaaaaaaaaaaaaaaaaaaaacaaaaaaaaaaaaaaaaaaabavavavavavavavavavavavavavavavavavavavavavavavavavavavavavavavavavavavavavavavavavavavavavavavavavavavavavavavavavav
aaaaacaaaaaaaaaaaaaaaaaaaaaaaaaaaaaaaaaaaaaaaaaaaaaaaaaaaaaaaaaaabadavavavavavavavavavavavavavavavavavavavavavavavavavavavavavavavavavavavavavavavavavavavavavavavavavavavavavavavavav
aaaaaaaaaaaaaaaaaaaaaaaaaaaaaaaaaaaaaaaaaaaaaaaaaaaaaaaaaaaaaaaaaaabavavavavavavavavavavavavavavavavavavavavavavavavavavavavavavavavavavavavavavavavavavavavavavavavavavavavavavavavav
aaaaaaaaaaaaaaaaaaaaaaacaaaaaaaaaaaaaaaaaaaaaaaaaaaaaaaaacaaaaaaaaabadavavavavavavavavavavavavavavavavavavavavavavavavavavavavavavavavavavavavavavavavavavavavavavavavavavavavavavavav
aaaaaaaaaaaaaaaaaaaaaaaaaaaaaaaaaaaaaaaaaaaaaaaaaaaaaaaaaaaaaaaaaaaaabavavavavavavavavavavavavavavavavavavavavavavavavavavavavavavavavavavavavavavavavavavavavavavavavavavavavavavavav
aaaaaaaaaaaaaaaaaaaaaaaaaaaaaaaaaaaaaaaaaaaaaaaaaaaaaaaaaaaaaaaaaaaaabadavavavavavavavavavavavavavavavavavavavavavavavavavavavavavavavavavavavavavavavavavavavavavavavavavavavavavavav
aaaaaaaaaaaaaaaeaeaeaeaeaeaeaeaeaeaeaeaeaeaaaaaaaaaaaaaaaaaaaaaaaaaaacabavavavavavavavavavavavavavavavavavavavavavavavavavavavavavavavavavavavavavavavavavavavavavavavavavavavavavavav
aaaaaaaaacaaaaaeaeaeaeaeaeaeaeaeaeaeaeaeaeaaaaacaaaaaaaaaaaaaaaaaaaaaaabadavavavavavavavavavavavavavavavavavavavavavavavavavavavavavavavavavavavavavavavavavavavavavavavavavavavavavav
aaaaaaaaaaaaafaeaeagahahahahahahahahaiaeaeafafafafafafafafafafafafafafafajadavavavavavavavavavavavavavavavavavavavavavavavavavavavavavavavavavavavavavavavavavavavavavavavavavavavavav
aaaaaaaaaaabaaaeaeakakalamananaoaoapaqaeaeaaaaaaaaaaaaaaacaaaaaaaaaaaaaaaaabadavavavavavavavavavavavavavavavavavavavavavavavavavavavavavavavavavavavavavavavavavavavavavavavavavavavav
aaaaaaaaaaabaaaeaeananananararananananaeaeasasasasasasasasasasasasasasasasaaabadavavavavavavavavavavavavavavavavavavavavavavavavavavavavavavavavavavavavavavavavavavavavavavavavavavav
aaaaaaaaaaabaaaeaeananananananananananaeaeasasasasasaeaeaeaeaeaeaeaeaeaeaeaeaeabadavavavavavavavavavavavavavavavavavavavavavavavavavavavavavavavavavavavavavavavavavavavavavavavavavav
aaaaaaaaaaabaaaeaeananananananananananaeaeasasasasasaeaeaeaeaeaeaeaeaeaeaeaeaeaaabadavavavavavavavavavavavavavavavavavavavavavavavavavavavavavavavavavavavavavavavavavavavavavavavavav
aaaaaaaaaaabaaaeaeananananananananananaeaeasasasasasaeaeagahahahahahahahaiaeaeasaaabadavavavavavavavavavavavavavavavavavavavavavavavavavavavavavavavavavavavavavavavavavavavavavavavav
aaaaaaaaaaabaaaeaeananananananananananaeaeasasasasasaeaeatatatatatatatatataeaeasaaaaabadavavavavavavavavavavavavavavavavavavavavavavavavavavavavavavavavavavavavavavavavavavavavavavav
aaaaaaaaaaabaaaeaeaeaeataeaeaeaeataeaeaeaeasasasasasaeaeauatauatauatauatauaeaeasaaacaaabavavavavavavavavavavavavavavavavavavavavavavavavavavavavavavavavavavavavavavavavavavavavavavav
aaaaaaaaaaabaaaeaeawaxayazaAaBaCayaDaEaeaeasasasasasaeaeatatatatatatatatataeaeasaaaaabaFavavavavavavavavavavavavavavavavavavavavavavavavavavavavavavavavavavavavavavavavavavavavavavav
aaaaaaaaaaabaaaeaeaGaHataIaJaKaLataMaNaeaeasasasasasaeaeatatatatatatatatataeaeasabaFaFaOavavavavavavavavavavavavavavavavavavavavavavavavavavavavavavavavavavavavavavavavavavavavavavav
aaacaaaaaaabaaaeaeatatatatatatatatatataeaeasasasasasaeaeauatatauatauatatauaeaeasabaOaOavavavavavavavavavavavavavavavavavavavavavavavavavavavavavavavavavavavavavavavavavavavavavavavav
aaaaaaaaaaabaaaeaeatatatatatatatatatataeaeasasasasasaeaeaeaeataeaeaeataeaeaeaeasabadavavavavavavavavavavavavavavavavavavavavavavavavavavavavavavavavavavavavavavavavavavavavavavavavav
aaaaaaaaaaabaaaeaeaPatatatatatatatataQaeaeasasasasasaeaeagaiayagahaiayagaiaeaeasaaabavavavavavavavavavavavavavavavavavavavavavavavavavavavavavavavavavavavavavavavavavavavavavavavavav
aaaaaaaaaaabaaaeaeaPatatatatatatatataQaeaeasasasasasaeaeatatatatatatatatataeaeasasaaabadavavavavavavavavavavavavavavavavavavavavavavavavavavavavavavavavavavavavavavavavavavavavavavav
aaaaaaaaaaabaaaeaeaPatatatatatatatataQaeaeasasasasasaeaeatatataRaSaTatatataeaeasasasaaabadavavavavavavavavavavavavavavavavavavavavavavavavavavavavavavavavavavavavavavavavavavavavavav
aaaaaaaaaaabaaaeaeaUatatatatatatatataVaeaeasasasasasaeaeatatatatatatatatataeaeasasasasaaabadavavavavavavavavavavavavavavavavavavavavavavavavavavavavavavavavavavavavavavavavavavavavav
aaaaaaaaaaabaaaeaeaUatatatatatatatataVaeaeasasasasasaeaeaeaeaeatatataeaeaeaeaeasasasasasaaabadavavavavavavavavavavavavavavavavavavavavavavavavavavavavavavavavavavavavavavavavavavavav
aaaaaaaaaaabaaaeaeaUatataRaSaSaTatataVaeaeasasasasasaeaeaeaeaeasasasaeaeaeaeaeasasasasasasacabadavavavavavavavavavavavavavavavavavavavavavavavavavavavavavavavavavavavavavavavavavavav
aaaaaaaaaaabaaaeaeatatatatatatatatatataeaeasasasasasagahahahaiasasasagahahahaiasasasasasasasaaabadavavavavavavavavavavavavavavavavavavavavavavavavavavavavavavavavavavavavavavavavavav
aaaaaaacacabaaaeaeatatatatatatatatatataeaeasasasasasasasasasasasasasasasasasasasasasasasasasasaaabadavavavavavavavavavavavavavavavavavavavavavavavavavavavavavavavavavavavavavavavavav
aaaaaaaaaaabaaaeaeatatatatatatatatatataeaeasasasasasasasasasasasasasasasasasasasasasasasasasasasacabavavavavavavavavavavavavavavavavavavavavavavavavavavavavavavavavavavavavavavavavav
aaaaaaaaaaabaaaeaeaeaeatataeaeaeaeaeaeaeaeasasasasasasasasasasasasasasasasasasasasasasasasasasasasabadavavavavavavavavavavavavavavavavavavavavavavavavavavavavavavavavavavavavavavavav
acaaaaaaaaabaaaeaeaeaeaWaWaeaeaeaeaeaeaeaeasasasasasasasasasasasasasasasasasasasasasasasasasasasasaaabavavavavavavavavavavavavavavavavavavavavavavavavavavavavavavavavavavavavavavavav
aaaaaaaaaaabaaagahahaiasasasasasasagahahaiasasasasasasasasasasasasasasasasasasasasasasasasasasasasasaXaXaXaXaXaXaXaXaXaXaXaXaXaXaXaXaXaXaXaXaXaXaXaXaXaXaYavavavavavavavavavavavavavav
aaaaaaaaaaabaaaZbababbagahahaiaWaWaZbababbasasasasasasasasasasasasasasasasasasasasasasasasasasasasasbcbcbcbcbcbcbcbcbcbcbcbcbcbcbcbcbcbcbcbcbcbcbcbcbcbcbdavavavavavavavavavavavavavav
aaaaaaaaaaabaaasasasasasasasasasasasasasasasasasasasasasasasasasasasasasasasasasasasasasasasasasasasbebebebebebebebebebebebebebebebebebebebebebebebebebebfavavavavavavavavavavavavavav
aaaaaaaaaaabaaasasasasasasasasasasasasasasasasasasasasasasasasasasasasasasasasasasasasasasasasaaaaabaFavavbgbhbibjavavbgbhbibjavavbgbhbibjavavbgbhbibjavavavavavavavavavavavavavavavav
aaaaaaaaaaabaaasasasasasasasasasasasasasasasasasasasasasasasasasasasasasasasasasasasasasasasaaabaFaFaOavavbibjavavavavbibjavavavavbibjavavavavbibjavavavavavavavavavavavavavavavavavav
aaaaaaaaaaabaaacasasasasasasasasasasasasasasasasasasasasasasasasasasasasasasasasasasasasasaaabaFaOaOavavavavavavavavavavavavavavavavavavavavavavavavavavavavavavavavavavavavavavavavav
aaaaaaaaaaabaaaaaaaaaaaaaaaaaaaaaaaaaaaaaaaaaaaaaaaaaaaaaaaaaaaaaaaaaaaaaaaaaaaaaaaaacaaaaabaFaOavavavavavavavavavavavavavavavavavavavavavavavavavavavavavavavavavavavavavavavavavavav
aaaaaaaaaaabaFaFaFaFaFaFaFaFaFaFaFaFaFaFaFaFaFaFaFaFbkaWblaFaFaFaFaFaFaFaFaFaFaFaFaFaFaFaFbmaOavavavavavavavavavavavavavavavavavavavavavavavavavavavavavavavavavavavavavavavavavavavav
aaaaaaaaaaaaaaaaaaaaaaaaaaaaaaaaaaaaaaaaaaaaaaaaaaaabkaWblaaaaaaaaaaaaaaaaaaaaaaaaaaabaOaOaOavavavavavavavavavavavavavavavavavavavavavavavavavavavavavavavavavavavavavavavavavavavavav
aaaaaaaaaaaaaaaaaaaaaaaaaaaaaaaaaaaaaaaaaaaaaaaaaaaaaaaaaaaaaaaaaaaaaaaaacaaaaaaaaaaabavavavavavavavavavavavavavavavavavavavavavavavavavavavavavavavavavavavavavavavavavavavavavavavav
aaaaaaaaaaaaaaaaaaaaaaacaaaaaaaaaaaaaaaaaaaaaaaaaaaaaaaaaaaaaaaaaaaaaaaaaaaaaaaaacaaabavavavavavavavavavavavavavavavavavavavavavavavavavavavavavavavavavavavavavavavavavavavavavavavav
aaaaaaaaacaaaaaaaaaaaaaaaaaaaaaaaaaaaaaaaaaaaaaaaaaaaaaaaaaaaaaaaaaaaaaaaaaaaaaaaaaaabavavavavavavavavavavavavavavavavavavavavavavavavavavavavavavavavavavavavavavavavavavavavavavavav
aaaaaaaaaaaaaaaaaaaaaaaaaaaaaaaaaaaaaaaaabaFaFaFaFaFaFaFaFbkaWblaFaFaFbnaaaaaaaaaaaaabavavavavavavavavavavavavavavavavavavavavavavavavavavavavavavavavavavavavavavavavavavavavavavavav
aaaaaaaaaaaaaaaaaaaaaaaaaaaaaaaaaaaaaaaaabaaaaaaaaaaaaaaaabkaWblaaaaaabnaaaaaaaaaaaaabavavavavavavavavavavavavavavavavavavavavavavavavavavavavavavavavavavavavavavavavavavavavavavavav
aaaaaaaaaaaaaaaaaaaaaaaaaaaaaaaaaaaaaaaaabaaaaaaaaaaaaaaaaaaaaaaaaaaaabnaaaaaaaaaaaaabavavavavavavavavavavavavavavavavavavavavavavavavavavavavavavavavavavavavavavavavavavavavavavavav
aaaaaaaaaaaaaaaaaaaaaaaaaaaaaaaaaaaaaaaaabaaaaaaaaaaaaaaaaaaaaaaaaaaaabnaaaaaaaaaaaaabavavavavavavavavavavavavavavavavavavavavavavavavavavavavavavavavavavavavavavavavavavavavavavavav
aaaaaaaaaaaaaaaaaaaaaaaaaaaaaaaaaaacaaaaabaaaaaaaaaaaaaaaaaaaaaaaaaaaabnaaaaaaaaaaaaabavavavavavavavavavavavavavavavavavavavavavavavavavavavavavavavavavavavavavavavavavavavavavavavav
aaaaaaaaaaaaaaaaaaaaaaaaaaaaaaaaaaaaaaaaabaaaaacaaaaaaaaaaaaaaaaaaaaaabnaaaaaaaaaaaaabavavavavavavavavavavavavavavavavavavavavavavavavavavavavavavavavavavavavavavavavavavavavavavavav
aaaaaaaaaaaaaaaaaaaaaaaaaaaaaaaaaaaaaaaaabaaaaaaaaaaaaaaaaaaaaaaaaaaaabnaaaaaaaaaaaaabavavavavavavavavavavavavavavavavavavavavavavavavavavavavavavavavavavavavavavavavavavavavavavavav
aaaaaaaaaaaaaaaaaaaaaaaaaaaaaaaaaaaaaaaaabaaaaaaaaaaaaaaaaaaaaaaaaaaaabnaaaaaaaaaaaaabavavavavavavavavavavavavavavavavavavavavavavavavavavavavavavavavavavavavavavavavavavavavavavavav
aaaaaaaaacaaaaaaaaaaaaaaaaaaaaaaaaaaaaaaabaaaaaaaaaaaaaaaaaaaaaaaaaaaabnaaaaaaaaaaabaOavavavavavavavavavavavavavavavavavavavavavavavavavavavavavavavavavavavavavavavavavavavavavavavav
aaaaaaaaaaaaaaaaaaaaaaaaaaaaaaaaaaaaaaaaabaaaaaaaaaaaaaaaaaaaaaaaaaaaaaOaOaOaOaOaOaOavavavavavavavavavavavavavavavavavavavavavavavavavavavavavavavavavavavavavavavavavavavavavavavavav
aaaaaaaaaaaaaaaaaaaaaaaaaaaaaaaaaaaaaaaaabaaaaaaaaaaaaaaaaaaaaaaaaaaboavavavavavavavavavavavavavavavavavavavavavavavavavavavavavavavavavavavavavavavavavavavavavavavavavavavavavavavav
aaaaaaaaaaaaaaaaaaaaaaaaaaaaaaaaaaaaaaaaabaaaaaaaaaaaaaaaaboboboboboavavavavavavavavavavavavavavavavavavavavavavavavavavavavavavavavavavavavavavavavavavavavavavavavavavavavavavavavav
aaaaaaaaaaaaaaaaaaaaaaaaaaaaaaaaaaaaaaaaabaaaaaaaaaaaaaaboavavavavavavavavavavavavavavavavavavavavavavavavavavavavavavavavavavavavavavavavavavavavavavavavavavavavavavavavavavavavavav
aaaaaaaaaaaaaaaaaaaaaaaaaaaaaaaaaaaaaaaaabaaaaboboboboboavavavavavavavavavavavavavavavavavavavavavavavavavavavavavavavavavavavavavavavavavavavavavavavavavavavavavavavavavavavavavavav
aaaaaaaaaaaaaaaaaaaaaaaaaaaaaaaaaaaaaaaaabboboavavavavavavavavavavavavavavavavavavavavavavavavavavavavavavavavavavavavavavavavavavavavavavavavavavavavavavavavavavavavavavavavavavavav
aaaaaaaaaaaaaaaaaaaaaaacaaaaaaaaaaaaaaaaabavavavavavavavavavavavavavavavavavavavavavavavavavavavavavavavavavavavavavavavavavavavavavavavavavavavavavavavavavavavavavavavavavavavavavav
aaaaaaaaaaaaaaaaaaaaaaaaaaaaaaaaaaaaaaaaabavavavavavavavavavavavavavavavavavavavavavavavavavavavavavavavavavavavavavavavavavavavavavavavavavavavavavavavavavavavavavavavavavavavavavav
aaaaaaaaaaaaaaaaaaaaaaaaaaaaaaaaaaaaaaaaabadadadadadadadadadadadadadadadadadavavavavavavavavavavavavavavavavavavavavavavavavavavavavavavavavavavavavavavavavavavavavavavavavavavavavav
aaaaaaaaaaaaaaaaaaaaaaaaaaaaaaaaaaaaaaaaaaaaaaaaaaaaaaaaaaaaaaaaaaaaaaaaaaabadavavavavavavavavavavavavavavavavavavavavavavavavavavavavavavavavavavavavavavavavavavavavavavavavavavavav
aaaaaaaaaaaaaaaaaaaaaaaaaaaaaaaaaaaaaaaaaaaaaaaaaaaaaaaaaaaaacaaaaaaaaaaaaaaabavavavavavavavavavavavavavavavavavavavavavavavavavavavavavavavavavavavavavavavavavavavavavavavavavavavav
aaaaaaaaaaaaaaaaaaaaaaaaaaaaaaaaaaaaaaaaaaaaaaaaaaaaaaaaaaaaaaaaaaaaaaaaaaaaabavavavavavavavavavavavavavavavavavavavavavavavavavavavavavavavavavavavavavavavavavavavavavavavavavavavav
aaaaaaaaaaaaaaaaaaaaaaaaaaaaaaaaaaaaaaaaaaaaaaaaaaaaaaaaaaaaaaaaaaaaaaaaaaaaabadavavavavavavavavavavavavavavavavavavavavavavavavavavavavavavavavavavavavavavavavavavavavavavavavavavav
aaaaaaaaaaaaaaaaaaaaaaaaaaaaaaacaaaaaaaaaaaaaaaaaaaaaaaaaaaaaaaaaaaaaaaaaaaaaaabavavavavavavavavavavavavavavavavavavavavavavavavavavavavavavavavavavavavavavavavavavavavavavavavavavav
aaaaaaaaaaaaaaaaaaaaaaaaaaaaaaaaaaaaaaaaaaaaaaaaaaacaaaaaaaaaaaaaaaaaaaaaaaaaaabavavavavavavavavavavavavavavavavavavavavavavavavavavavavavavavavavavavavavavavavavavavavavavavavavavav
aaaaaaaaaaaaaaaaaaaaaaaaaaaaaaaaaaaaaaaaaaaaaaaaaaaaaaaaaaaaaaaaaaaaaaaaacaaaaabadavavavavavavavavavavavavavavavavavavavavavavavavavavavavavavavavavavavavavavavavavavavavavavavavavav
aaaaaaaaaaaaaaaaaaaaaaaaaaaaaaaaaaaaaaaaaaaaaaaaaaaaaaaaaaaaaaaaaaaaaaaaaaaaaaaaabavavavavavavavavavavavavavavavavavavavavavavavavavavavavavavavavavavavavavavavavavavavavavavavavavav
aaaaaaaaaaaaaaaaaaaaaaaaaaaaaaaaaaaaaaaaaaaaaaaaaaaaaaaaaaaaaaaaaaaaaaaaaaaaaaaaabavavavavavavavavavavavavavavavavavavavavavavavavavavavavavavavavavavavavavavavavavavavavavavavavavav
aaaaaaaaaaaaaaaaaaaaaaaaaaaaaaaaaaaaaaaaaaaaaaaaaaaaaaaaaaaaaaaaaaaaaaaaaaaaaaaaabadavavavavavavavavavavavavavavavavavavavavavavavavavavavavavavavavavavavavavavavavavavavavavavavavav
aaaaaaaaaaaaaaaaaaaaaaaaaaaaaaaaaaaaaaacaaaaaaaaaaaaaaaaaaaaaaaaaaaaaaaaaaaaaaaaaaabavavavavavavavavavavavavavavavavavavavavavavavavavavavavavavavavavavavavavavavavavavavavavavavavav
aaaaaaaaaaaaaaaaaaaaaaaaaaaaaaaaaaaaaaaaaaaaaaaaaaaaaaaaaaaaaaaaaaaaaaacaaaaaaaaaaabadavavavavavavavavavavavavavavavavavavavavavavavavavavavavavavavavavavavavavavavavavavavavavavavav
aaaaaaaaaaaaaaaaaaaaaaaaaaaaaaaaaaaaaaaaaaaaaaaaaaaaaaaaaaaaaaaaaaaaaaaaaaaaaaaaaaaaabadavavavavavavavavavavavavavavavavavavavavavavavavavavavavavavavavavavavavavavavavavavavavavavav
aaaaaaaaaaaaaaaaaaaaaaaaaaaaaaaaaaaaaaaaaaaaaaaaaaaaaaaaaaaaaaaaaaaaaaaaaaaaaaaaaaaaaaabadavavavavavavavavavavavavavavavavavavavavavavavavavavavavavavavavavavavavavavavavavavavavavav
aaaaaaaaaaaaaaaaaaaaaaaaaaaaaaaaaaaaaaaaaaaaaaaaaaaaaaaaaaaaaaaaaaaaaaaaaaaaaaaaaaaaaaaaabadadavavavavavavavavavavavavavavavavavavavavavavavavavavavavavavavavavavavavavavavavavavavav
aaaaaaaaaaaaaaaaaaaaaaaaaaaaaaaaaaaaaaaaaaaaaaaaaaaaaaaaaaaaaaaaaaaaaaaaaaaaaaaaaaaaaaaaaaaaabadadadavavavavavavavavavavavavavavavavavavavavavavavavavavavavavavavavavavavavavavavavav
"}
