"a" = (/turf/Special/Blank,/area)
"b" = (/turf/Grass23,/area)
"c" = (/obj/Turfs/Edges/Edge4N,/turf/Grass23,/area)
"d" = (/obj/Turfs/Edges/Edge4N,/obj/Turfs/Edges/Edge4E,/turf/Grass23,/area)
"e" = (/obj/Turfs/Edges/Edge4W,/turf/Grass23,/area)
"f" = (/obj/Turfs/Edges/Edge4E,/turf/Grass23,/area)
"g" = (/turf/Roof10,/area)
"h" = (/turf/Wall1,/area)
"i" = (/turf/Wood16,/area)
"j" = (/turf/Stairs1,/area)
"k" = (/obj/Turfs/bridgeS,/turf/Wall13,/area)
"l" = (/obj/Turfs/bridgeS,/obj/Turfs/bridgeS,/turf/Wall13,/area)
"m" = (/obj/Turfs/bridgeW,/obj/Turfs/bridgeS,/turf/Wall13,/area)
"n" = (/obj/Turfs/bridgeE,/obj/Turfs/bridgeS,/turf/Wall13,/area)
"o" = (/obj/Turfs/bridgeS,/obj/Turfs/Edges/Edge4E,/turf/Wall13,/area)
"p" = (/turf/Wall13,/area)
"q" = (/obj/Turfs/bridgeW,/turf/Wall13,/area)
"r" = (/turf/Wood16,/turf/Edges/Grass23EdgeW,/turf/Edges/Grass23NW,/area)
"s" = (/turf/Wood16,/turf/Edges/Grass23EdgeN,/area)
"t" = (/turf/Wood16,/turf/Edges/Grass23EdgeE,/turf/Edges/Grass23NE,/area)
"u" = (/obj/Turfs/bridgeE,/turf/Wall13,/area)
"v" = (/turf/Wood16,/turf/Edges/Grass23EdgeW,/area)
"w" = (/turf/Wood16,/turf/Edges/Grass23EdgeE,/area)
"x" = (/obj/Turfs/bridgeW,/turf/Grass23,/area)
"y" = (/obj/Turfs/bridgeE,/turf/Grass23,/area)
"z" = (/turf/Wood16,/turf/Edges/Grass23EdgeS,/area)
"A" = (/obj/Turfs/Plant5,/turf/Grass23,/area)
"B" = (/obj/Turfs/Trees/RedPine,/turf/Grass23,/area)
"C" = (/obj/Turfs/Rock2,/turf/Grass23,/area)

(1,1,1) = {"
aabbbbbbbbbbbbbbbbbbbbbbbbbbbbbbbbbbbbbbbbbbbbbbbbaaaaaaaaaaaaaaaaaaaaaaaaaaaaaaa
aabbbbbbbbbbbbbbbbbbbbbbbbbbbbbbbbbbbbbbbbbbbbbbbbaaaaaaaaaaaaaaaaaaaaaaaaaaaaaaa
aabbcccccccccccccccccccccccccccccccccccccccccccdbbaaaaaaaaaaaaaaaaaaaaaaaaaaaaaaa
aabbebbbbbbbbbbbbbbbbbbbbbbbbbbbbbbbbbbbbbbbbbbfbbaaaaaaaaaaaaaaaaaaaaaaaaaaaaaaa
aabbeggggggggggggggggggggggggggggggggggggggggggfbbaaaaaaaaaaaaaaaaaaaaaaaaaaaaaaa
aabbeghhhhhhhhhhhhhhhhhghhhhhhhhhhhhhhhhhhhhhhgfbbaaaaaaaaaaaaaaaaaaaaaaaaaaaaaaa
aabbeghhhhhhhhhhhhhhhhhghhhhhhhhhhhhhhhhhhhhhhgfbbaaaaaaaaaaaaaaaaaaaaaaaaaaaaaaa
aabbeghhhhhhhhhhhhhhhhhghhhhhhhhhhhhhhhhhhhhhhgfbbaaaaaaaaaaaaaaaaaaaaaaaaaaaaaaa
aabbegiiiiiiiiiiiiiiiiigiiiiiiiiiiiiiiiiiiiiiigfbbaaaaaaaaaaaaaaaaaaaaaaaaaaaaaaa
aabbegiiiiiiiiiiiiiiiiigiiiiiiiiiiiiiiiiiiiiiigfbbaaaaaaaaaaaaaaaaaaaaaaaaaaaaaaa
aabbegiiiiiiiiiiiiiiiiigiiiiiiiiiiiiiiiiiiiiiigfbbaaaaaaaaaaaaaaaaaaaaaaaaaaaaaaa
aabbegiiiiiiiiiiiiiiiiigiiiiiiiiiiiiiiiiiiiiiigfbbaaaaaaaaaaaaaaaaaaaaaaaaaaaaaaa
aabbegiiiiiiiiiiiiiiiiigiiiiiiiiiiiiiiiiiiiiiigfbbaaaaaaaaaaaaaaaaaaaaaaaaaaaaaaa
aabbegiiiiiiiiiiiiiiiiigiiiiiiiiiiiiiiiiiiiiiigfbbaaaaaaaaaaaaaaaaaaaaaaaaaaaaaaa
aabbegiiiiiiiiiiiiiiiiigiiiiiiiiiiiiiiiiiiiiiigfbbaaaaaaaaaaaaaaaaaaaaaaaaaaaaaaa
aabbegiiiiiiiiiiiiiiiiigiiiiiiiiiiiiiiiiiiiiiigfbbaaaaaaaaaaaaaaaaaaaaaaaaaaaaaaa
aabbegiiiiiiiiiiiiiiiiigiiiiiiiiiiiiiiiiiiiiiigfbbaaaaaaaaaaaaaaaaaaaaaaaaaaaaaaa
aabbegiiiiiiiiiiiiiiiiigiiiiiiiiiiiiiiiiiiiiiigfbbaaaaaaaaaaaaaaaaaaaaaaaaaaaaaaa
aabbegiiiiiiiiiiiiiiiiigiiiiiiiiiiiiiiiiiiiiiigfbbaaaaaaaaaaaaaaaaaaaaaaaaaaaaaaa
aabbegggggggggiiigggggggggggggggiiiiiggggggggggfbbaaaaaaaaaaaaaaaaaaaaaaaaaaaaaaa
aabbeghhhhhhhhiiihhhhhhhhhhhhhhhiiiiihhhhhhhhhgfbbaaaaaaaaaaaaaaaaaaaaaaaaaaaaaaa
aabbegiiiiiiiiiiiiiiiiiiiiiiiiiiiiiiiiiiiiiiiigfbbaaaaaaaaaaaaaaaaaaaaaaaaaaaaaaa
aabbegiiiiiiiiiiiiiiiiiiiiiiiiiiiiiiiiiiiiiiiigfbbaaaaaaaaaaaaaaaaaaaaaaaaaaaaaaa
aabbegiiiiiiiiiiiiiiiiiiiiiiiiiiiiiiiiiiiiiiiigfbbaaaaaaaaaaaaaaaaaaaaaaaaaaaaaaa
aabbegiiiiiiiiiiiiiiiiiiiiiiiiiiiiiiiiiiiiiiiigfbbaaaaaaaaaaaaaaaaaaaaaaaaaaaaaaa
aabbegiiiiiiiiiiiiiiiiiiiiiiiiiiiiiiiiiiiiiiiigfbbaaaaaaaaaaaaaaaaaaaaaaaaaaaaaaa
aabbegiiiiiiiiiiiiiiiiiiiiiiiiiiiiiiiiiiiiiiiigfbbaaaaaaaaaaaaaaaaaaaaaaaaaaaaaaa
aabbegiiiiiiiiiiiiiiiiiiiiiiiiiiiiiiiiiiiiiiiigfbbaaaaaaaaaaaaaaaaaaaaaaaaaaaaaaa
aabbegiiiiiiiiiiiiiiiiiiiiiiiiiiiiiiiiiiiiiiiigfbbaaaaaaaaaaaaaaaaaaaaaaaaaaaaaaa
aabbegiiiiiiiiiiiiiiiiiiiiiiiiiiiiiiiiiiiiiiiigfbbaaaaaaaaaaaaaaaaaaaaaaaaaaaaaaa
aabbegiiiiiiiiiiiiiiiiiiiiiiiiiiiiiiiiiiiiiiiigfbbaaaaaaaaaaaaaaaaaaaaaaaaaaaaaaa
aabbegiiiiiiiiiiiiiiiiiiiiiiiiiiiiiiiiiiiiiiiigfbbaaaaaaaaaaaaaaaaaaaaaaaaaaaaaaa
aabbegiiiiiiiiiiiiiiiiiiiiiiiiiiiiiiiiiiiiiiiigfbbaaaaaaaaaaaaaaaaaaaaaaaaaaaaaaa
aabbegiiiiiiiiiiiiiiiiiiiiiiiiiiiiiiiiiiiiiiiigfbbaaaaaaaaaaaaaaaaaaaaaaaaaaaaaaa
aabbegiiiiiiiiiiiiiiiiiiiiiiiiiiiiiiiiiiiiiiiigfbbaaaaaaaaaaaaaaaaaaaaaaaaaaaaaaa
aabbegggggggggggggiigiiiiiiiiiigiigggggggggggggfbbaaaaaaaaaaaaaaaaaaaaaaaaaaaaaaa
aabbeghhhhhhhhhhhhiigiiiiiiiiiigiihhhhhhhhhhhhgfbbaaaaaaaaaaaaaaaaaaaaaaaaaaaaaaa
aabbegiiiiiiiiiiiiiigiiiiiiiiiigiiiiiiiiiiiiiigfbbaaaaaaaaaaaaaaaaaaaaaaaaaaaaaaa
aabbegiiiiiiiiiiiiiigiiiiiiiiiigiiiiiiiiiiiiiigfbbaaaaaaaaaaaaaaaaaaaaaaaaaaaaaaa
aabbegiiiiiiiiiiiiiigiiiiiiiiiigiiiiiiiiiiiiiigfbbaaaaaaaaaaaaaaaaaaaaaaaaaaaaaaa
aabbegiiiiiiiiiiiiiigiiiiiiiiiigiiiiiiiiiiiiiigfbbaaaaaaaaaaaaaaaaaaaaaaaaaaaaaaa
aabbegiiiiiiiiiiiiiigiiiiiiiiiigiiiiiiiiiiiiiigfbbaaaaaaaaaaaaaaaaaaaaaaaaaaaaaaa
aabbegiiiiiiiiiiiiiigiiiiiiiiiigiiiiiiiiiiiiiigfbbaaaaaaaaaaaaaaaaaaaaaaaaaaaaaaa
aabbegiiiiiiiiiiiiiigiiiiiiiiiigiiiiiiiiiiiiiigfbbaaaaaaaaaaaaaaaaaaaaaaaaaaaaaaa
aabbegiiiiiiiiiiiiiigiiiiiiiiiigiiiiiiiiiiiiiigfbbaaaaaaaaaaaaaaaaaaaaaaaaaaaaaaa
aabbeggggggggggggggggiiiiiiiiiiggggggggggggggggfbbaaaaaaaaaaaaaaaaaaaaaaaaaaaaaaa
aabbehhhhhhhhhhhhhhhhiiiiiiiiiihhhhhhhhhhhhhhhhfbbaaaaaaaaaaaaaaaaaaaaaaaaaaaaaaa
aabbehhhhhhhhhhhhhhhhiiiiiiiiiihhhhhhhhhhhhhhhhfbbaaaaaaaaaaaaaaaaaaaaaaaaaaaaaaa
aabbehhhhhhhhhhhhhhhhjjjjjjjjjjhhhhhhhhhhhhhhhhfbbaaaaaaaaaaaaaaaaaaaaaaaaaaaaaaa
aabbebbbbbbbbbbbbbbbbbbbbbbbbbbbbbbbbbbbbbbbbbbfbbaaaaaaaaaaaaaaaaaaaaaaaaaaaaaaa
aabbebbbbbbbbbbbbbbbbbbbbbbbbbbbbbbbbbbbbbbbbbbfbbaaaaaaaaaaaaaaaaaaaaaaaaaaaaaaa
aabbkkkkkkkkkklmbbbbbbbbbbbbbbbbbbbbnkkkkkkkkkkobbaaaaaaaaaaaaaaaaaaaaaaaaaaaaaaa
aabbpppppppppppqbbbbbbrsssssstbbbbbbupppppppppppbbaaaaaaaaaaaaaaaaaaaaaaaaaaaaaaa
aabbpppppppppppqbbbbbbviiiiiiwbbbbbbupppppppppppbbaaaaaaaaaaaaaaaaaaaaaaaaaaaaaaa
aabbbbbbbbbbbbbxbbbbbbviiiiiiwbbbbbbybbbbbbbbbbbbbaaaaaaaaaaaaaaaaaaaaaaaaaaaaaaa
aabbbbbbbbbbbbbxbbbbbbviiiiiiwbbbbbbybbbbbbbbbbbbbaaaaaaaaaaaaaaaaaaaaaaaaaaaaaaa
aabbbbbbbbbbbbbxbbbbbbviiiiiiwbbbbbbybbbbbbbbbbbbbaaaaaaaaaaaaaaaaaaaaaaaaaaaaaaa
aabbbbbbbbbbbbbxbbbbbbviiiiiiwbbbbbbybbbbbbbbbbbbbaaaaaaaaaaaaaaaaaaaaaaaaaaaaaaa
aabbbbbbbbbbbbbxbbbbbbviiiiiiwbbbbbbybbbbbbbbbbbbbaaaaaaaaaaaaaaaaaaaaaaaaaaaaaaa
aabbbbbbbbbbbbbxbbbbbbviiiiiiwbbbbbbybbbbbbbbbbbbbaaaaaaaaaaaaaaaaaaaaaaaaaaaaaaa
aabbbbbbbbbbbbbxbbbbbbviiiiiiwbbbbbbybbbbbbbbbbbbbaaaaaaaaaaaaaaaaaaaaaaaaaaaaaaa
aabbbbbbbbbbbbbxbbbbbbviiiiiiwbbbbbbybbbbbbbbbbbbbaaaaaaaaaaaaaaaaaaaaaaaaaaaaaaa
aabbbbbbbbbbbbbxbbbbbbviiiiiiwbbbbbbybbbbbbbbbbbbbaaaaaaaaaaaaaaaaaaaaaaaaaaaaaaa
aabbbbbbbbbbbbbxbbbbbbviiiiiiwbbbbbbybbbbbbbbbbbbbaaaaaaaaaaaaaaaaaaaaaaaaaaaaaaa
aabbbbbbbbbbbbbxbbbbbbviiiiiiwbbbbbbybbbbbbbbbbbbbaaaaaaaaaaaaaaaaaaaaaaaaaaaaaaa
aabbbbbbbbbbbbbxbbbbbbviiiiiiwbbbbbbybbbbbbbbbbbbbaaaaaaaaaaaaaaaaaaaaaaaaaaaaaaa
aabbbbbbbbbbbbbxhhhhhhhjjjjjjhhhhhhhybbbbbbbbbbbbbaaaaaaaaaaaaaaaaaaaaaaaaaaaaaaa
aabbbbbbbbbbbbbxhhhhhhhjjjjjjhhhhhhhybbbbbbbbbbbbbaaaaaaaaaaaaaaaaaaaaaaaaaaaaaaa
aabbbbbbbbbbbbbxbbbbbbrsssssstbbbbbbybbbbbbbbbbbbbaaaaaaaaaaaaaaaaaaaaaaaaaaaaaaa
aabbbbbbbbbbbbbxbbbbbbviiiiiiwbbbbbbybbbbbbbbbbbbbaaaaaaaaaaaaaaaaaaaaaaaaaaaaaaa
aabbbbbbbbbbbbbxbbbbbbviiiiiiwbbbbbbybbbbbbbbbbbbbaaaaaaaaaaaaaaaaaaaaaaaaaaaaaaa
aabbbbbbbbbbbbbxbbbbbbviiiiiiwbbbbbbybbbbbbbbbbbbbaaaaaaaaaaaaaaaaaaaaaaaaaaaaaaa
aabbbbbbbbbbbbbxbbbbbbviiiiiiwbbbbbbybbbbbbbbbbbbbaaaaaaaaaaaaaaaaaaaaaaaaaaaaaaa
aabbbbbbbbbbbbbxbbbbbbviiiiiiwbbbbbbybbbbbbbbbbbbbaaaaaaaaaaaaaaaaaaaaaaaaaaaaaaa
aabbbbbbbbbbbbbxbbbbbbviiiiiiwbbbbbbybbbbbbbbbbbbbaaaaaaaaaaaaaaaaaaaaaaaaaaaaaaa
aabbbbbbbbbbbbbxbbbbbbviiiiiiwbbbbbbybbbbbbbbbbbbbaaaaaaaaaaaaaaaaaaaaaaaaaaaaaaa
aabbbbbbbbbbbbbxbbbbbbviiiiiiwbbbbbbybbbbbbbbbbbbbaaaaaaaaaaaaaaaaaaaaaaaaaaaaaaa
aabbbbbbbbbbbbbxbbbbbbviiiiiiwbbbbbbybbbbbbbbbbbbbaaaaaaaaaaaaaaaaaaaaaaaaaaaaaaa
aabbbbbbbbbbbbbxbbbbbbviiiiiiwbbbbbbybbbbbbbbbbbbbaaaaaaaaaaaaaaaaaaaaaaaaaaaaaaa
aabbbbbbbbbbbbbxbbbbbbviiiiiiwbbbbbbybbbbbbbbbbbbbaaaaaaaaaaaaaaaaaaaaaaaaaaaaaaa
aabbbbbbbbbbbbbxbbbbbbviiiiiiwbbbbbbybbbbbbbbbbbbbaaaaaaaaaaaaaaaaaaaaaaaaaaaaaaa
aabbbbbbbbbbbbbxbbbbbbviiiiiiwbbbbbbybbbbbbbbbbbbbaaaaaaaaaaaaaaaaaaaaaaaaaaaaaaa
aabbbbbbbbbbbbbxhhhhhhhjjjjjjhhhhhhhybbbbbbbbbbbbbaaaaaaaaaaaaaaaaaaaaaaaaaaaaaaa
aabbbbbbbbbbbbbxhhhhhhhjjjjjjhhhhhhhybbbbbbbbbbbbbaaaaaaaaaaaaaaaaaaaaaaaaaaaaaaa
aabbbbbbbbbbbbbbbbbbbbbbbbbbbbbbbbbbbbbbbbbbbbbbbbaaaaaaaaaaaaaaaaaaaaaaaaaaaaaaa
aabbbbbbbbbbbbbbbbbbbbbbbbbbbbbbbbbbbbbbbbbbbbbbbbaaaaaaaaaaaaaaaaaaaaaaaaaaaaaaa
aabbbbbbbbbbbbbbbbbbbbrsssssstbbbbbbbbbbbbbbbbbbbbaaaaaaaaaaaaaaaaaaaaaaaaaaaaaaa
aabbbbbbbbbbbbbbbbbbbbviiiiiiwbbbbbbbbbbbbbbbbbbbbaaaaaaaaaaaaaaaaaaaaaaaaaaaaaaa
aabbbbbbbbbbbbbbbbbbbbviiiiiiwbbbbbbbbbbbbbbbbbbbbaaaaaaaaaaaaaaaaaaaaaaaaaaaaaaa
aabbbbbbbbbbbbbbbbbbbbviiiiiiwbbbbbbbbbbbbbbbbbbbbaaaaaaaaaaaaaaaaaaaaaaaaaaaaaaa
aabbbbbbbbbbbbbbbbbbbbviiiiiiwbbbbbbbbbbbbbbbbbbbbaaaaaaaaaaaaaaaaaaaaaaaaaaaaaaa
aabbbbbbbbbbbbbbbbbbbbviiiiiiwbbbbbbbbbbbbbbbbbbbbaaaaaaaaaaaaaaaaaaaaaaaaaaaaaaa
aabbbbbbbbbbbbbbbbbbbbviiiiiiwbbbbbbbbbbbbbbbbbbbbaaaaaaaaaaaaaaaaaaaaaaaaaaaaaaa
aabbbbbbbbbbbbbbbbbbbbviiiiiiwbbbbbbbbbbbbbbbbbbbbaaaaaaaaaaaaaaaaaaaaaaaaaaaaaaa
aabbbbbbbbbbbbbbbbbbbbviiiiiiwbbbbbbbbbbbbbbbbbbbbaaaaaaaaaaaaaaaaaaaaaaaaaaaaaaa
aabbbbbbbbbbbbbbbbbbbbviiiiiiwbbbbbbbbbbbbbbbbbbbbaaaaaaaaaaaaaaaaaaaaaaaaaaaaaaa
aabbbbbbbbbbbbbbbbbbbbviiiiiiwbbbbbbbbbbbbbbbbbbbbaaaaaaaaaaaaaaaaaaaaaaaaaaaaaaa
aabbbbbbbbbbbbbbbbbbbbviiiiiiwbbbbbbbbbbbbbbbbbbbbaaaaaaaaaaaaaaaaaaaaaaaaaaaaaaa
aabbbbbbbbbbbbbbbbbbbbviiiiiiwbbbbbbbbbbbbbbbbbbbbaaaaaaaaaaaaaaaaaaaaaaaaaaaaaaa
aabbbbbbbbbbbbbbbbbbbbviiiiiiwbbbbbbbbbbbbbbbbbbbbaaaaaaaaaaaaaaaaaaaaaaaaaaaaaaa
aabbbbbbbbbbbbbbbbbbbbviiiiiiwbbbbbbbbbbbbbbbbbbbbaaaaaaaaaaaaaaaaaaaaaaaaaaaaaaa
aabbbbbbbbbbbbbbbbbbbbviiiiiiwbbbbbbbbbbbbbbbbbbbbaaaaaaaaaaaaaaaaaaaaaaaaaaaaaaa
aabbbbbbbbbbbbbbbbbbbbviiiiiiwbbbbbbbbbbbbbbbbbbbbaaaaaaaaaaaaaaaaaaaaaaaaaaaaaaa
aabbbbbbbbbbbbbbbbbbbbviiiiiiwbbbbbbbbbbbbbbbbbbbbaaaaaaaaaaaaaaaaaaaaaaaaaaaaaaa
aabbbbbbbbbbbbbbbbbbbbviiiiiiwbbbbbbbbbbbbbbbbbbbbaaaaaaaaaaaaaaaaaaaaaaaaaaaaaaa
aabbbbbbbbbbbbbbbbbbbbviiiiiiwbbbbbbbbbbbbbbbbbbbbaaaaaaaaaaaaaaaaaaaaaaaaaaaaaaa
aabbbbbbbbbbbbbbbbbbbbviiiiiiwbbbbbbbbbbbbbbbbbbbbaaaaaaaaaaaaaaaaaaaaaaaaaaaaaaa
aabbbbbbbbbbbbbbbbbbbbviiiiiiwbbbbbbbbbbbbbbbbbbbbaaaaaaaaaaaaaaaaaaaaaaaaaaaaaaa
aabbbbbbbbbbbbbbbbbbbbviiiiiiwbbbbbbbbbbbbbbbbbbbbaaaaaaaaaaaaaaaaaaaaaaaaaaaaaaa
aabbbbbbbbbbbbbbbbbbbbviiiiiiwbbbbbbbbbbbbbbbbbbbbaaaaaaaaaaaaaaaaaaaaaaaaaaaaaaa
aabbbbbbbbbbbbbbbbbbbbviiiiiiwbbbbbbbbbbbbbbbbbbbbaaaaaaaaaaaaaaaaaaaaaaaaaaaaaaa
aabbbbbbbbbbbbbbbbbbbbviiiiiiwbbbbbbbbbbbbbbbbbbbbaaaaaaaaaaaaaaaaaaaaaaaaaaaaaaa
aabbbbbbbbbbbbbbbbbbbbviiiiiiwbbbbbbbbbbbbbbbbbbbbaaaaaaaaaaaaaaaaaaaaaaaaaaaaaaa
aabbbbbbbbbbbbbbbbbbbbviiiiiiwbbbbbbbbbbbbbbbbbbbbaaaaaaaaaaaaaaaaaaaaaaaaaaaaaaa
aabbbbbbbbbbbbbbbbbbbbviiiiiiwbbbbbbbbbbbbbbbbbbbbaaaaaaaaaaaaaaaaaaaaaaaaaaaaaaa
aabbbbbbbbbbbbbbbbbbbbviiiiiiwbbbbbbbbbbbbbbbbbbbbaaaaaaaaaaaaaaaaaaaaaaaaaaaaaaa
aabbbbbbggggggggggggggiiiiiiiiggggggggggggggbbbbbbaaaaaaaaaaaaaaaaaaaaaaaaaaaaaaa
aabbbbbgghhhhhhhhhhhhhiiiiiiiihhhhhhhhhhhhhggbbbbbaaaaaaaaaaaaaaaaaaaaaaaaaaaaaaa
aabbbbgghhhhhhhhhhhhhhzzzzzzzzhhhhhhhhhhhhhhggbbbbaaaaaaaaaaaaaaaaaaaaaaaaaaaaaaa
aabbbbghbbbbbbbbbbbbAbbbbbbbbbbAbbbbbbbbbbbbhgbbbbaaaaaaaaaaaaaaaaaaaaaaaaaaaaaaa
aabbbbbbbbbbbbbbbbbbbbbbbbbbbbbbbbbbbbbbbbbbbbbbbbaaaaaaaaaaaaaaaaaaaaaaaaaaaaaaa
aabbbbbbbbbbbbbbbbbBbbbbbbbbbbbbBbbbbbbbbbbbbbbbbbaaaaaaaaaaaaaaaaaaaaaaaaaaaaaaa
aabbbbbbbbbbbbBbbbbbbbbbbbbbbbbbbbbbbbbbbbbbbbbbbbaaaaaaaaaaaaaaaaaaaaaaaaaaaaaaa
aabbbbbbbbbbbbbbbbbbbbbbbbbbbbbbbbbbbBbbbbbbbbbbbbaaaaaaaaaaaaaaaaaaaaaaaaaaaaaaa
aabbbbbbbbCbbbbbbbbbbbbbbbbbbbbbbbbbbbbbCbbbbbbbbbaaaaaaaaaaaaaaaaaaaaaaaaaaaaaaa
"}
