"aa" = (/turf/Roof3,/area/Outside)
"ab" = (/obj/Turfs/Edges/DarkEdgeW,/turf/Stairs2,/area/Outside)
"ac" = (/turf/Stairs2,/area/Outside)
"ad" = (/obj/Turfs/Edges/DarkEdgeE,/turf/Stairs2,/area/Outside)
"ae" = (/obj/Turfs/Edges/DarkEdgeW,/obj/Turfs/Edges/DarkEdgeN,/turf/Wall6,/area/Outside)
"af" = (/obj/Turfs/Edges/DarkEdgeE,/obj/Turfs/Edges/DarkEdgeN,/turf/Wall6,/area/Outside)
"ag" = (/obj/Turfs/Edges/DarkEdgeN,/turf/Wall6,/area/Outside)
"ah" = (/obj/Turfs/Edges/DarkEdgeW,/turf/Wall6,/area/Outside)
"ai" = (/obj/Turfs/Edges/DarkEdgeE,/turf/Wall6,/area/Outside)
"aj" = (/turf/Wall6,/area/Outside)
"ak" = (/turf/Tech2,/area/Outside)
"al" = (/obj/Turfs/Edges/DarkEdgeE,/turf/Tech2,/area/Outside)
"am" = (/turf/Special/Blank,/area/Outside)
"an" = (/obj/Turfs/Chest,/turf/Tech2,/area/Outside)
"ao" = (/obj/Turfs/MidgarObj/Steelstool,/turf/Tech2,/area/Outside)
"ap" = (/obj/Turfs/MidgarObj/Widescreen,/turf/Wall6,/area/Outside)
"aq" = (/obj/Turfs/IconsXLBig/Icon5,/turf/Tech2,/area/Outside)
"ar" = (/obj/Turfs/Table6,/turf/Tech2,/area/Outside)
"as" = (/obj/Turfs/MidgarObj/MidgarBarrel,/turf/Tech2,/area/Outside)
"at" = (/obj/Turfs/TechObject2,/turf/Tech2,/area/Outside)
"au" = (/obj/Turfs/Console2,/turf/Tech2,/area/Outside)
"av" = (/obj/Turfs/Console3,/turf/Tech2,/area/Outside)
"aw" = (/obj/Turfs/MidgarObj/Midgarchest,/turf/Tech2,/area/Outside)
"ax" = (/obj/Turfs/Console6Top,/turf/Tech2,/area/Outside)
"ay" = (/obj/Turfs/Console1,/turf/Tech2,/area/Outside)
"az" = (/obj/Items/Tech/Regenerator,/turf/Tech2,/area/Outside)
"aA" = (/obj/Turfs/Console1,/obj/Turfs/Console6Top,/turf/Tech2,/area/Outside)
"aB" = (/obj/Turfs/Console4,/turf/Tech2,/area/Outside)
"aC" = (/obj/Turfs/Console5,/turf/Tech2,/area/Outside)
"aD" = (/obj/Turfs/Edges/DarkEdgeN,/obj/Turfs/Edges/DarkEdgeW,/turf/Wall6,/area/Outside)
"aE" = (/obj/Turfs/Edges/DarkEdgeW,/obj/Turfs/Edges/DarkEdgeN,/obj/Turfs/IconsX/Icon1,/turf/Wall26,/area/Outside)
"aF" = (/obj/Turfs/Edges/DarkEdgeN,/obj/Turfs/IconsX/Icon3,/turf/Wall26,/area/Outside)
"aG" = (/obj/Turfs/Edges/DarkEdgeN,/obj/Turfs/IconsX/Icon5,/turf/Wall26,/area/Outside)
"aH" = (/obj/Turfs/Edges/DarkEdgeN,/obj/Turfs/IconsX/Icon4,/turf/Wall26,/area/Outside)
"aI" = (/obj/Turfs/Edges/DarkEdgeN,/obj/Turfs/IconsX/Icon2,/turf/Wall26,/area/Outside)
"aJ" = (/obj/Turfs/Edges/DarkEdgeE,/obj/Turfs/Edges/DarkEdgeN,/turf/Wall26,/area/Outside)
"aK" = (/obj/Turfs/IconsX/Icon11,/turf/Tile12,/area/Outside)
"aL" = (/obj/Turfs/IconsX/Icon12,/turf/Tile12,/area/Outside)
"aM" = (/obj/Turfs/IconsX/Icon14,/turf/Tile12,/area/Outside)
"aN" = (/turf/Tile12,/area/Outside)
"aO" = (/obj/Turfs/MidgarObj/Stool,/turf/Tech2,/area/Outside)
"aP" = (/obj/Turfs/Door,/turf/Tile12,/area/Outside)
"aQ" = (/obj/Turfs/RoofGlass,/turf/Tech2,/area/Outside)
"aR" = (/obj/Turfs/IconsX/Icon7,/turf/Tile12,/area/Outside)
"aS" = (/obj/Turfs/IconsX/Icon25,/turf/Tile12,/area/Outside)
"aT" = (/obj/Turfs/Table5,/turf/Tile14,/area/Outside)
"aU" = (/obj/Turfs/Table4,/turf/Tile14,/area/Outside)
"aV" = (/obj/Turfs/Table3,/turf/Tile14,/area/Outside)
"aW" = (/obj/Turfs/Edges/DarkEdgeW,/obj/Turfs/Edges/DarkEdgeE,/obj/Turfs/Edges/DarkEdgeN,/obj/Turfs/MidgarObj/TV,/turf/Wall26,/area/Outside)
"aX" = (/obj/Turfs/Table5,/turf/Carpet6,/area/Outside)
"aY" = (/obj/Turfs/Table4,/turf/Carpet6,/area/Outside)
"aZ" = (/obj/Turfs/Table3,/turf/Carpet6,/area/Outside)
"ba" = (/obj/Special/Teleporter2{gotoX = 304; gotoY = 201; gotoZ = 1},/turf/Tech2,/area/Outside)
"bb" = (/obj/Special/Teleporter2{gotoX = 305; gotoY = 201; gotoZ = 1},/turf/Tech2,/area/Outside)
"bc" = (/obj/Special/Teleporter2{gotoX = 309; gotoY = 201; gotoZ = 1},/turf/Tech2,/area/Outside)
"bd" = (/obj/Special/Teleporter2{gotoX = 310; gotoY = 201; gotoZ = 1},/turf/Tech2,/area/Outside)

(1,1,1) = {"
aaaaaaaaaaaaaaaaaaaaaaaaaaaaaaaaaaaaaaaaaaaaaaaaaaaaaaaaaaaaaaaaaaaaaaaaaaaaaaaaaaaaaaabacacacacacadaaaaaaaaaaaaaaaaaaaaaaaaaaaaaaaaaaaaaaaaaaaaaaaaaaaaaaaaaaaaaaaaaaaaaaaaaaaaaaaaaaaaaa
aaaaaaaaaaaaaaaaaaaaaaaaaaaaaaaaaaaaaaaaaaaaaaaaaaaaaaaaaaaaaaaaaaaaaaaaaaaaaaaaaaaeafabacacacacacadaeafaaaaaaaaaaaaaaaaaaaaaaaaaaaaaaaaaaaaaaaaaaaaaaaaaaaaaaaaaaaaaaaaaaaaaaaaaaaaaaaaaa
aaaaaeagagagagagagagagagagagagagagagagagagagagagagagagagagagagagagagagagagagagagafahaiabacacacacacadahaiaeagagagagagagagagagagagagagagagagagagagagagagagagagagagagagagagagagagagagagafaaaa
aaaaahajajajajajajajajajajajajajajajajajajajajajajajajajajajajajajajajajajajajajaiahaiabacacacacacadahaiahajajajajajajajajajajajajajajajajajajajajajajajajajajajajajajajajajajajajajaiaaaa
aaaaahajajajajajajajajajajajajajajajajajajajajajajajajajajajajajajajajajajajajajaiakabacacacacacacacacalahajajajajajajajajajajajajajajajajajajajajajajajajajajajajajajajajajajajajajaiaaaa
aaaaakakakakakakakakakakakakakakakakakakakakakakakakakakakakakakakakakakakakakakakakakakakakakakakakakakakakakakakakakakakakakakakakakakakakakakakakakakakakakakakakakakakakakakakakakaaaa
aaaaakakakakakakakakakakakakakakakakakakakakakakakakakakakakakakakakakakakakakakakakakakakakakakakakakakakakakakakakakakakakakakakakakakakakakakakakakakakakakakakakakakakakakakakakakaaaa
aaaaakakakakakakakakakakakakakakakakakakakakakakakakakakakakakakakakakakakakakakakakakakakakakakakakakakakakakakakakakakakakakakakakakakakakakakakakakakakakakakakakakakakakakakakakakaaaa
aaaaakakakakakakakakakakakakakakakakakakakakakakakakakakakakakakakakakakakakakakakakakakakakakakakakakakakakakakakakakakakakakakakakakakakakakakakakakakakakakakakakakakakakakakakakakaaaa
aaaaakakakakakakakakakakakakakakakakakakakakakakakakakakakakakakakakakakakakakakakakakakakakakakakakakakakakakakakakakakakakakakakakakakakakakakakakakakakakakakakakakakakakakakakakakaaaa
aaaaakakakaaaaaaaaaaaaaaaaaaaaaaaaaaaaaaaaaaaaaaaaaaaaaaaaaaaaaaaaaaaaaaaaaaaaaaaaaaaaaaaaaaaaaaaaaaaaaaaaaaaaaaaaaaaaaaaaaaaaaaaaaaaaaaaaaaaaaaaaaaaaaaaaaaaaaaaaaaaaaaaaaaaaaaakakakaaaa
aaaaabacadaaaaaaaaaaaaaaaaaaaaaaaaaaaaaaaaaaaaaaaaaaaaaaaaaaaaaaaaaaaaaaaaaaaaaaaaaaaaaaaaaaaaaaaaaaaaaaaaaaaaaaaaaaaaaaaaaaaaaaaaaaaaaaaaaaaaaaaaaaaaaaaaaaaaaaaaaaaaaaaaaaaaaaacacacaaaa
aaaaabacadaaaaamamamamamamamamamamamamamamamamamamamamamamamamamamamamamamamamamamamamamamamamamamamamamamamamamamamamamamamamamamamamamamamamamamamamamamamamamamamamamamamaaaaacacacaaaa
aaaaabacadaaaaamamamamamamamamamamamamamamamamamamamamamamamamamamamamamamamamamamamamamamamamamamamamamamamamamamamamamamamamamamamamamamamamamamamamamamamamamamamamamamamaaaaacacacaaaa
aaaaabacadaaaaamamamamamamamamamamamamamamamamamamamamamamamamamamamamamamamamamamamamamamamamamamamamamamamamamamamamamamamamamamamamamamamamamamamamamamamamamamamamamamamaaaaacacacaaaa
aaaaabacadaaaaamamamamamamamamamamamamamamamamamamamamamamamamamamamamamamamamamamamamamamamamamamamamamamamamamamamamamamamamamamamamamamamamamamamamamamamamamamamamamamamaaaaacacacaaaa
aaaaabacadaaaaaaaaaaaaaaaaaaaaaaaaaaaaaaaaaaaaaaaaaaaaaaaaaaaaaaaaaaaaaaaaaaaaaaaaaaaaaaaaaaaaaaaaaaaaaaaaaaaaaaaaaaaaaaaaaaaaaaaaaaaaaaaaaaaaaaaaaaaaaaaaaaaaaaaaaaaaaaaaaaaaaaacacacaaaa
aaaaabacadaaaaaeagagagagagagagagagagagagagagagagagagagagagagagagagafaaaeagagagagagagagagagagagagagagagagagagagagagafaaaeagagagagagagagagagagaaaeagafaaaeagagagagagagagagagagaaaaacacacaaaa
aaaaabacadaaaaahajajajajajajajajajajajajajajajajajajajajajajajajajaiaaahajajajajajajajajajajajajajajajajajajajajajaiaaakanakakakaoakakakanakaaahajaiaaakanakakakaoakakakanakaaaaacacacaaaa
aaaaabacadaaaaahajajajajajajajajajajajajajajajajajajajajajajajajajaiaaahajajajapajajajajajajajajajajajajajapajajajaiaaaqakakakaoaraoakakakaqaaahajaiaaaqakakakaoaraoakakakaqaaaaacacacaaaa
aaaaabacadaaaaasatakakakauakavakauakakakakakakauakavakauakakakakawawaaakakakakakakakakavakakaxakavakakakakakakakakakaaakanakakakaoakakakanakaaakakakaaakanakakakaoakakakanakaaaaacacacaaaa
aaaaabacadaaaaakakayazaAakakakakakakaAazayazaAakakakakakakaAazayawakaaakakakakakakakakakakayaBayakakakakakakakakakakaaaqakakakakakakakakakaqaaakakakaaaqakakakakakakakakakaqaaaaacacacaaaa
aaaaabacadaaaaakakakakaCakakakakakakaCakakakaCakakakakakakaCakakakakaaakakakakakakakakakakakakakakakakakakakakakakakaaakakakakakakakakakakakaaakakakaaakakakakakakakakakakakaaaaacacacaaaa
aaaaabacadaaaaakakakakakakakakakakakakakakakakakakakakakakakakakakakaaakakakakakakakakakakakakakakakakakakakakakakakaaaaaaaaaaakakakaaaaaaaaaaakakakaaaaaaaaaaakakakaaaaaaaaaaaaacacacaaaa
aaaaabacadaaaaakakakakakakakakakakakakakakakakakakakakakakakakakakakaaakakakakakakakakakakakakakakakakakakakakakakakaaaeagagafacacacaeagagagafakakakaeagagagafacacacaeagagafaaaaacacacaaaa
aaaaabacadaaaaakakakakakakakakakakakakakakakakakakakakakakakakakakakaaakakakakakakakakakakakakakakakakakakakakakakakaaahajajaiacacacahajajajaiakakakahajajajaiacacacahajajaiaaaaacacacaaaa
aaaaabacadaaaaakakakakakakakakakakakakakakakakakakakakakakakakakakakaaakakakaoaoaoaoaoaoakakakakakaoaoaoaoaoaoakakakaaakakakakakakakakakakakakakakakakakakakakakakakakakakakaaaaacacacaaaa
aaaaabacadaaaaakakakakakakakakakakakakakakakakakakakakakakakakakakakaaakakakakakakakakakakakakakakakakakakakakakakakaaaaaaaaaaacacacaaaaaaaaaaakakakaaaaaaaaaaacacacaaaaaaaaaaaaacacacaaaa
aaaaabacadaaaaakakakakakakakakakakakakakakakakakakakakakakakakakakakaaakakakaoaoaoaoaoaoakakakakakaoaoaoaoaoaoakakakaaaeagagafacacacaeagagafaaakakakaaaeagagafacacacaeagagafaaaaacacacaaaa
aaaaabacadaaaaakakakakakakakakakakakakakakakakakakakakakakakakakakakaaakakakakakakakakakakakakakakakakakakakakakakakaaanakakakakaoakakakanakaaakakakaaanakakakakaoakakakanakaaaaacacacaaaa
aaaaabacadaaaaakakakakakakakakakakakakakakakakakakakakakakakakakakakaaakakakaoaoaoaoaoaoakakakakakaoaoaoaoaoaoakakakaaakaqakakaoaraoakakakaqaaakakakaaakaqakakaoaraoakakakaqaaaaacacacaaaa
aaaaabacadaaaaakakakakakakakakakakakakakakakakakakakakakakakakakakakaaakakakakakakakakakakakakakakakakakakakakakakakaaanakakakakaoakakakanakaaakakakaaanakakakakaoakakakanakaaaaacacacaaaa
aaaaabacadaaaaakakakakakakakakakakakakakakakakakakakakakakakakakakakaaakakakakakakakakakakakakakakakakakakakakakakakaaakaqakakakakakakakakaqaaakakakaaakaqakakakakakakakakaqaaaaacacacaaaa
aaaaabacadaaaaaaaaaaaaaaaaaaaaaaaaaaaaakakakaaaaaaaaaaaaaaaaaaaaaaaaaaaaaaaaaaaaaaaaaaaaaaakakakaaaaaaaaaaaaaaaaaaaaaaaaaaaaaaaaaaaaaaaaaaaaaaakakakaaaaaaaaaaaaaaaaaaaaaaaaaaaaacacacaaaa
aaaaabacadaaaaaaaaaaaaaaaaaaaaaaaaaaaaakakakaaaaaaaaaaaaaaaaaaaaaaaaaaaaaaaaaaaaaaaaaaaaaaakakakaaaaaaaaaaaaaaaaaaaaaaaaaaaaaaaaaaaaaaaaaaaaaaakakakaaaaaaaaaaaaaaaaaaaaaaaaaaaaacacacaaaa
aaaaabacadaeagagagagagagagagagagagagafakakakaeagagagagagagagagagagagagagagagagagagagagagafakakakaeagagagagagagagagagagagagagagagagagagagagagafakakakaeagagagagagagagagagagagagafacacacaaaa
aaaaabacadahajajajajajajajajajajajajaiakakakahajajajajajajajajajajajajajajajajajajajajajaiakakakahajajajajajajajajajajajajajajajajajajajajajaiakakakahajajajajajajajajajajajajaiacacacaaaa
aaaaabacadahajajajajajajajajajajajajaiakakakahajajajajajajajajajajajajajajajajajajajajajaiakakakahajajajajajajajajajajajajajajajajajajajajajaiakakakahajajajajajajajajajajajajaiacacacaaaa
aaaaabacadakakakakakakakakakakakakakakakakakakakakakakakakakakakakakakakakakakakakakakakakakakakakakakakakakakakakakakakakakakakakakakakakakakakakakakakakakakakakakakakakakakakacacacaaaa
aaaaakakakakakakakakakakakakakakakakakakakakakakakakakakakakakakakakakakakakakakakakakakakakakakakakakakakakakakakakakakakakakakakakakakakakakakakakakakakakakakakakakakakakakakakakakaaaa
aaaaakakakakakakakakakakakakakakakakakakakakakakakakakakakakakakakakakakakakakakakakakakakakakakakakakakakakakakakakakakakakakakakakakakakakakakakakakakakakakakakakakakakakakakakakakaaaa
aaaaakakakakakakakakakakakakakakakakakakakakakakakakakakakakakakakakakakakakakakakakakakakakakakakakakakakakakakakakakakakakakakakakakakakakakakakakakakakakakakakakakakakakakakakakakaaaa
aaaaaaaaaaaaaaaaaaaaaaaaaaaaaaaaaaaaaaaaaaaaaaaaaaaaaaaaaaaaaaaaaaaaaaaaaaaaaaaaaaakakakakakakakakakakakaaaaaaaaaaaaaaaaaaaaaaaaaaaaaaaaaaaaaaaaaaaaaaaaaaaaaaaaaaaaaaaaaaaaaaaaaaaaaaaaaa
aaaaaaaaaaaaaaaaaaaaaaaaaaaaaaaaaaaaaaaaaaaaaaaaaaaaaaaaaaaaaaaaaaaaaaaaaaaaaaaaaaaaaaakakakakakakakaaaaaaaaaaaaaaaaaaaaaaaaaaaaaaaaaaaaaaaaaaaaaaaaaaaaaaaaaaaaaaaaaaaaaaaaaaaaaaaaaaaaaa
amamamamamamamamamamamamamamamamamamamamamamamamamamamamamamamamamamamamamamamamamaaaaakakakakakakakaaaaamamamamamamamamamamamamamamamamamamamamamamamamamamamamamamamamamamamamamamamamam
amamamamamamamamamamamamamamamamamamamamamamamamamamamamamamamamamamamamamamamamamaaaaakakakakakakakaaaaamamamamamamamamamamamamamamamamamamamamamamamamamamamamamamamamamamamamamamamamam
amamamamamamamamamamamamamamamamamamamamamamamamamamamamaaaaaaaaaaaaaaaaaaaaaaaaaaaaaaakakakakakakakaaaaaaaaaaaaaaaaaaaaaaaaaaaaaaaaaaaaaaaaaaamamamamamamamamamamamamamamamamamamamamamam
amamamamamamamamamamamamamamamamamamamamamamamamamamamamaaaaaaaaaaaaaaaaaaaaaaaaaaaeafakakakakakakakaeafaaaaaaaaaaaaaaaaaaaaaaaaaaaaaaaaaaaaaaamamamamamamamamamamamamamamamamamamamamamam
amamamamamamamamamamamamamamamamamamamamamamamamamamamamaaaaaDagagagagagagagagagafahaiakakakakakakakahaiaeagagagagagagagafaaaeagagagagagafaaaaamamamamamamamamamamamamamamamamamamamamamam
amamamamamamamamamamamamamamamamamamamamamamamamamamamamaaaaahajajajajajajajajajaiahaiakakakakakakakahaiahajajajajajajajaiaaahajajajajajaiaaaaamamamamamamamamamamamamamamamamamamamamamam
amamamamamamamamamamamamamamamamamamamamamamamamamamamamaaaaahajajajajajajajajajaiakakakakakakakakakakakahajajajajajajajaiaaaEaFaGaHaIaIaJaaaaamamamamamamamamamamamamamamamamamamamamamam
amamamamamamamamamamamamamamamamamamamamamamamamamamamamaaaaakakakakakakakakakakakakakakakakakakakakakakakakakakakakakakakaaaKaKaLaMaNaNaNaaaaamamamamamamamamamamamamamamamamamamamamamam
amamamamamamamamamamamamamamamamamamamamamamamamamamamamaaaaakakakakakakakakakakakakakakakaOakaOakakakakakakakakakakakakakaPaNaNaNaNaNaNaNaaaaamamamamamamamamamamamamamamamamamamamamamam
amamamamamamamamamamamamamamamamamamamamamamamamamamamamaaaaakakakakakakakakakakakakaaaaaQaQaQaQaQaaaaakakakakakakakakakakaaaNaNaNaNaNaRaSaaaaamamamamamamamamamamamamamamamamamamamamamam
amamamamamamamamamamamamamamamamamamamamamamamamamamamamaaaaakakakakakakakakakakakakaeafaTaUaUaUaVaeafakakakakaoakakakaoakaWaXaYaYaYaYaYaZaaaaamamamamamamamamamamamamamamamamamamamamamam
amamamamamamamamamamamamamamamamamamamamamamamamamamamamaaaaakakakakakakakakakakakakakakakakakakakakakakakakaoaraoakaoaraoakakakakakakakakaaaaamamamamamamamamamamamamamamamamamamamamamam
amamamamamamamamamamamamamamamamamamamamamamamamamamamamaaaaakakakakakakakakakakakakakakakakakakakakakakakakakaoakakakaoakakakakakakakakakaaaaamamamamamamamamamamamamamamamamamamamamamam
amamamamamamamamamamamamamamamamamamamamamamamamamamamamaaaaakakakakakakakakakakakakakakakakakakakakakakakakakaoakakakaoakakakaoakakakaoakaaaaamamamamamamamamamamamamamamamamamamamamamam
amamamamamamamamamamamamamamamamamamamamamamamamamamamamaaaaakakakakakakakakakakakakakakakakakakakakakakakakaoaraoakaoaraoakaoaraoakaoaraoaaaaamamamamamamamamamamamamamamamamamamamamamam
amamamamamamamamamamamamamamamamamamamamamamamamamamamamaaaaakakakakakakakakakakakakakakakakakakakakakakakakakaoakakakaoakakakaoakakakaoakaaaaamamamamamamamamamamamamamamamamamamamamamam
amamamamamamamamamamamamamamamamamamamamamamamamamamamamaaaaaaaaaaaaaaaaaaaaaaaaaababbaaaaaaaaaaaaaabcbdaaaaaaaaaaaaaaaaaaaaaaaaaaaaaaaaaaaaaaamamamamamamamamamamamamamamamamamamamamamam
amamamamamamamamamamamamamamamamamamamamamamamamamamamamaaaaaaaaaaaaaaaaaaaaaaaaaaaaaaaaaaaaaaaaaaaaaaaaaaaaaaaaaaaaaaaaaaaaaaaaaaaaaaaaaaaaaaamamamamamamamamamamamamamamamamamamamamamam
amamamamamamamamamamamamamamamamamamamamamamamamamamamamamamamamamamamamamamamamaaaaaaaaamamamamamaaaaaaaaamamamamamamamamamamamamamamamamamamamamamamamamamamamamamamamamamamamamamamamam
"}
