"a" = (/turf/Special/Stars{density = 1; Grabbable = 0},/area/Outside)
"b" = (/turf/Stone11,/area/Outside)
"c" = (/obj/Special/Teleporter2{gotoX = 205; gotoY = 181; gotoZ = 19; Grabbable = 0},/turf/Stone12,/area/Outside)
"d" = (/turf/Stairs4,/area/Outside)
"e" = (/turf/Carpet5,/area/Outside)
"f" = (/obj/Special/Teleporter2{gotoX = 372; gotoY = 252; gotoZ = 18; Grabbable = 0},/turf/Carpet7,/area/Outside)

(1,1,1) = {"
aaaaaaaaaaaaaaaaaaaaaaaaaaaaaaaaaaaaaaaaa
aaaaaaaaaaaaaaaaaaaaaaaaaaaaaaaaaaaaaaaaa
aaaaaaaaaaaaaaaaaaaaaaaaaaaaaaaaaaaaaaaaa
aaaaaaaaaaaaaaaaaaaaaaaaaaaaaaaaaaaaaaaaa
aaaaaaaaaaaaaaaaaaaaaaaaaaaaaaaaaaaaaaaaa
aaaaaaaaaaaaaaaaaaaaaaaaaaaaaaaaaaaaaaaaa
aaaaaaaaaaaaaaaaaaaaaaaaaaaaaaaaaaaaaaaaa
aaaaaaaaaaaaaaaaaaaaaaaaaaaaaaaaaaaaaaaaa
aaaaaaaaaaaaaaaaaaaaaaaaaaaaaaaaaaaaaaaaa
aaaaaaaaaaaaaaaaaaaaaaaaaaaaaaaaaaaaaaaaa
aaaaaaaaaaaaaaaaaaaaaaaaaaaaaaaaaaaaaaaaa
aaaaaaaaaaaaaaaaaaaaaaaaaaaaaaaaaaaaaaaaa
aaaaaaaaaaaaaaaaaaaaaaaaaaaaaaaaaaaaaaaaa
aaaaaaaaaaaaaaaaaaaaaaaaaaaaaaaaaaaaaaaaa
aaaaaaaaaaaaaaaaaaaaaaaaaaaaaaaaaaaaaaaaa
aaaaaaaaaaaaaaaaabbbbbbbaaaaaaaaaaaaaaaaa
aaaaaaaaaaaaaaaaabbbcbbbaaaaaaaaaaaaaaaaa
aaaaaaaaaaaaaaaaabbbbbbbaaaaaaaaaaaaaaaaa
aaaaaaaaaaaaaaaaadddddddaaaaaaaaaaaaaaaaa
aaaaaaaaaaaaaaaaadddddddaaaaaaaaaaaaaaaaa
aaaaaaaaaaaaaaaaadddddddaaaaaaaaaaaaaaaaa
aaaaaaaaaaaaaaaaadddddddaaaaaaaaaaaaaaaaa
aaaaaaaaaaaaaaaaadddddddaaaaaaaaaaaaaaaaa
aaaaaaaaaaaaaaaaadddddddaaaaaaaaaaaaaaaaa
aaaaaaaaaaaaaaaaadddddddaaaaaaaaaaaaaaaaa
aaaaaaaaaaaaaaaaadddddddaaaaaaaaaaaaaaaaa
aaaaaaaaaaaaaaaaadddddddaaaaaaaaaaaaaaaaa
aaaaaaaaaaaaaaaaadddddddaaaaaaaaaaaaaaaaa
aaaaaaaaaaaaaaaaadddddddaaaaaaaaaaaaaaaaa
aaaaaaaaaaaaaaaaadddddddaaaaaaaaaaaaaaaaa
aaaaaaaaaaaaaaaaadddddddaaaaaaaaaaaaaaaaa
aaaaaaaaaaaaaaaaadddddddaaaaaaaaaaaaaaaaa
aaaaaaaaaaaaaaaaadddddddaaaaaaaaaaaaaaaaa
aaaaaaaaaaaaaaaaadddddddaaaaaaaaaaaaaaaaa
aaaaaaaaaaaaaaaaadddddddaaaaaaaaaaaaaaaaa
aaaaaaaaaaaaaaaaadddddddaaaaaaaaaaaaaaaaa
aaaaaaaaaaaaaaaaadddddddaaaaaaaaaaaaaaaaa
aaaaaaaaaaaaaaaaadddddddaaaaaaaaaaaaaaaaa
aaaaaaaaaaaaaaaaadddddddaaaaaaaaaaaaaaaaa
aaaaaaaaaaaaaaaaadddddddaaaaaaaaaaaaaaaaa
aaaaaaaaaaaaaaaaadddddddaaaaaaaaaaaaaaaaa
aaaaaaaaaaaaaaaaadddddddaaaaaaaaaaaaaaaaa
aaaaaaaaaaaaaaaaadddddddaaaaaaaaaaaaaaaaa
aaaaaaaaaaaaaaaaadddddddaaaaaaaaaaaaaaaaa
aaaaaaaaaaaaaaaaadddddddaaaaaaaaaaaaaaaaa
aaaaaaaaaaaaaaaaadddddddaaaaaaaaaaaaaaaaa
aaaaaaaaaaaaaaaaadddddddaaaaaaaaaaaaaaaaa
aaaaaaaaaaaaaaaaadddddddaaaaaaaaaaaaaaaaa
aaaaaaaaaaaaaaaaadddddddaaaaaaaaaaaaaaaaa
aaaaaaaaaaaaaaaaadddddddaaaaaaaaaaaaaaaaa
aaaaaaaaaaaaaaaaadddddddaaaaaaaaaaaaaaaaa
aaaaaaaaaaaaaaaaadddddddaaaaaaaaaaaaaaaaa
aaaaaaaaaaaaaaaaadddddddaaaaaaaaaaaaaaaaa
aaaaaaaaaaaaaaaaadddddddaaaaaaaaaaaaaaaaa
aaaaaaaaaaaaaaaaadddddddaaaaaaaaaaaaaaaaa
aaaaaaaaaaaaaaaaadddddddaaaaaaaaaaaaaaaaa
aaaaaaaaaaaaaaaaadddddddaaaaaaaaaaaaaaaaa
aaaaaaaaaaaaaaaaadddddddaaaaaaaaaaaaaaaaa
aaaaaaaaaaaaaaaaadddddddaaaaaaaaaaaaaaaaa
aaaaaaaaaaaaaaaaadddddddaaaaaaaaaaaaaaaaa
aaaaaaaaaaaaaaaaadddddddaaaaaaaaaaaaaaaaa
aaaaaaaaaaaaaaaaadddddddaaaaaaaaaaaaaaaaa
aaaaaaaaaaaaaaaaadddddddaaaaaaaaaaaaaaaaa
aaaaaaaaaaaaaaaaadddddddaaaaaaaaaaaaaaaaa
aaaaaaaaaaaaaaaaadddddddaaaaaaaaaaaaaaaaa
aaaaaaaaaaaaaaaaadddddddaaaaaaaaaaaaaaaaa
aaaaaaaaaaaaaaaaadddddddaaaaaaaaaaaaaaaaa
aaaaaaaaaaaaaaaaadddddddaaaaaaaaaaaaaaaaa
aaaaaaaaaaaaaaaaadddddddaaaaaaaaaaaaaaaaa
aaaaaaaaaaaaaaaaadddddddaaaaaaaaaaaaaaaaa
aaaaaaaaaaaaaaaaadddddddaaaaaaaaaaaaaaaaa
aaaaaaaaaaaaaaaaadddddddaaaaaaaaaaaaaaaaa
aaaaaaaaaaaaaaaaadddddddaaaaaaaaaaaaaaaaa
aaaaaaaaaaaaaaaaadddddddaaaaaaaaaaaaaaaaa
aaaaaaaaaaaaaaaaadddddddaaaaaaaaaaaaaaaaa
aaaaaaaaaaaaaaaaadddddddaaaaaaaaaaaaaaaaa
aaaaaaaaaaaaaaaaadddddddaaaaaaaaaaaaaaaaa
aaaaaaaaaaaaaaaaadddddddaaaaaaaaaaaaaaaaa
aaaaaaaaaaaaaaaaadddddddaaaaaaaaaaaaaaaaa
aaaaaaaaaaaaaaaaadddddddaaaaaaaaaaaaaaaaa
aaaaaaaaaaaaaaaaadddddddaaaaaaaaaaaaaaaaa
aaaaaaaaaaaaaaaaadddddddaaaaaaaaaaaaaaaaa
aaaaaaaaaaaaaaaaadddddddaaaaaaaaaaaaaaaaa
aaaaaaaaaaaaaaaaadddddddaaaaaaaaaaaaaaaaa
aaaaaaaaaaaaaaaaadddddddaaaaaaaaaaaaaaaaa
aaaaaaaaaaaaaaaaadddddddaaaaaaaaaaaaaaaaa
aaaaaaaaaaaaaaaaadddddddaaaaaaaaaaaaaaaaa
aaaaaaaaaaaaaaaaadddddddaaaaaaaaaaaaaaaaa
aaaaaaaaaaaaaaaaadddddddaaaaaaaaaaaaaaaaa
aaaaaaaaaaaaaaaaadddddddaaaaaaaaaaaaaaaaa
aaaaaaaaaaaaaaaaadddddddaaaaaaaaaaaaaaaaa
aaaaaaaaaaaaaaaaadddddddaaaaaaaaaaaaaaaaa
aaaaaaaaaaaaaaaaadddddddaaaaaaaaaaaaaaaaa
aaaaaaaaaaaaaaaaadddddddaaaaaaaaaaaaaaaaa
aaaaaaaaaaaaaaaaadddddddaaaaaaaaaaaaaaaaa
aaaaaaaaaaaaaaaaadddddddaaaaaaaaaaaaaaaaa
aaaaaaaaaaaaaaaaadddddddaaaaaaaaaaaaaaaaa
aaaaaaaaaaaaaaaaadddddddaaaaaaaaaaaaaaaaa
aaaaaaaaaaaaaaaaadddddddaaaaaaaaaaaaaaaaa
aaaaaaaaaaaaaaaaadddddddaaaaaaaaaaaaaaaaa
aaaaaaaaaaaaaaaaadddddddaaaaaaaaaaaaaaaaa
aaaaaaaaaaaaaaaaadddddddaaaaaaaaaaaaaaaaa
aaaaaaaaaaaaaaaaadddddddaaaaaaaaaaaaaaaaa
aaaaaaaaaaaaaaaaadddddddaaaaaaaaaaaaaaaaa
aaaaaaaaaaaaaaaaadddddddaaaaaaaaaaaaaaaaa
aaaaaaaaaaaaaaaaadddddddaaaaaaaaaaaaaaaaa
aaaaaaaaaaaaaaaaadddddddaaaaaaaaaaaaaaaaa
aaaaaaaaaaaaaaaaadddddddaaaaaaaaaaaaaaaaa
aaaaaaaaaaaaaaaaadddddddaaaaaaaaaaaaaaaaa
aaaaaaaaaaaaaaaaadddddddaaaaaaaaaaaaaaaaa
aaaaaaaaaaaaaaaaadddddddaaaaaaaaaaaaaaaaa
aaaaaaaaaaaaaaaaadddddddaaaaaaaaaaaaaaaaa
aaaaaaaaaaaaaaaaadddddddaaaaaaaaaaaaaaaaa
aaaaaaaaaaaaaaaaaeeeeeeeaaaaaaaaaaaaaaaaa
aaaaaaaaaaaaaaaaaeeefeeeaaaaaaaaaaaaaaaaa
aaaaaaaaaaaaaaaaaeeeeeeeaaaaaaaaaaaaaaaaa
aaaaaaaaaaaaaaaaaaaaaaaaaaaaaaaaaaaaaaaaa
aaaaaaaaaaaaaaaaaaaaaaaaaaaaaaaaaaaaaaaaa
aaaaaaaaaaaaaaaaaaaaaaaaaaaaaaaaaaaaaaaaa
aaaaaaaaaaaaaaaaaaaaaaaaaaaaaaaaaaaaaaaaa
aaaaaaaaaaaaaaaaaaaaaaaaaaaaaaaaaaaaaaaaa
aaaaaaaaaaaaaaaaaaaaaaaaaaaaaaaaaaaaaaaaa
aaaaaaaaaaaaaaaaaaaaaaaaaaaaaaaaaaaaaaaaa
aaaaaaaaaaaaaaaaaaaaaaaaaaaaaaaaaaaaaaaaa
aaaaaaaaaaaaaaaaaaaaaaaaaaaaaaaaaaaaaaaaa
aaaaaaaaaaaaaaaaaaaaaaaaaaaaaaaaaaaaaaaaa
aaaaaaaaaaaaaaaaaaaaaaaaaaaaaaaaaaaaaaaaa
aaaaaaaaaaaaaaaaaaaaaaaaaaaaaaaaaaaaaaaaa
aaaaaaaaaaaaaaaaaaaaaaaaaaaaaaaaaaaaaaaaa
aaaaaaaaaaaaaaaaaaaaaaaaaaaaaaaaaaaaaaaaa
aaaaaaaaaaaaaaaaaaaaaaaaaaaaaaaaaaaaaaaaa
"}
