"aa" = (/turf/MidgarTiles/MidgarRoofSouth,/area/Inside)
"ab" = (/turf/MidgarTiles/MidgarRoofNorth,/area/Inside)
"ac" = (/turf/MidgarTiles/MidgarRoofEast,/area/Inside)
"ad" = (/turf/MidgarTiles/MidgarRoofWest,/area/Inside)
"ae" = (/obj/Turfs/Edges/DarkEdgeW,/obj/Turfs/Edges/DarkEdgeN,/turf/MidgarTiles/MidgarLightWall3,/area/Inside)
"af" = (/obj/Turfs/Edges/DarkEdgeN,/turf/MidgarTiles/MidgarLightWall3,/area/Inside)
"ag" = (/obj/Turfs/Edges/DarkEdgeE,/obj/Turfs/Edges/DarkEdgeN,/turf/MidgarTiles/MidgarLightWall3,/area/Inside)
"ah" = (/obj/Turfs/Edges/DarkEdgeW,/turf/MidgarTiles/Midgarwall5,/area/Inside)
"ai" = (/turf/MidgarTiles/Midgarwall5,/area/Inside)
"aj" = (/obj/Turfs/Edges/DarkEdgeE,/turf/MidgarTiles/Midgarwall5,/area/Inside)
"ak" = (/obj/Turfs/Edges/DarkEdgeW,/turf/MidgarTiles/MidgarLightWall3,/area/Inside)
"al" = (/turf/MidgarTiles/MidgarLightWall3,/area/Inside)
"am" = (/obj/Turfs/Edges/DarkEdgeE,/turf/MidgarTiles/MidgarLightWall3,/area/Inside)
"an" = (/turf/MidgarTiles/MidgarWall4,/obj/Turfs/Edges/DarkEdgeW,/turf/Special/Midgar_IchorWall,/area/Inside)
"ao" = (/turf/MidgarTiles/MidgarWall4,/turf/Special/Midgar_IchorWall,/area/Inside)
"ap" = (/turf/MidgarTiles/MidgarWall4,/obj/Turfs/Edges/DarkEdgeE,/turf/Special/Midgar_IchorWall,/area/Inside)
"aq" = (/turf/Special/Ichor_Water,/area/Inside)
"ar" = (/obj/Turfs/Edges/MetalEdgeS,/turf/Special/Ichor_Water,/area/Inside)
"as" = (/obj/Turfs/Edges/MetalEdgeE,/turf/Special/Ichor_Water,/area/Inside)
"at" = (/obj/Turfs/Edges/MetalEdgeW,/obj/Turfs/Edges/MetalEdgeN,/turf/MidgarTiles/MidgarTile1,/area/Inside)
"au" = (/obj/Turfs/Edges/MetalEdgeN,/turf/MidgarTiles/MidgarTile1,/area/Inside)
"av" = (/obj/Turfs/Edges/MetalEdgeN,/obj/Special/Teleporter2{gotoX = 121; gotoY = 196; gotoZ = 1},/turf/MidgarTiles/MidgarTile1,/area/Inside)
"aw" = (/obj/Turfs/Edges/MetalEdgeW,/turf/MidgarTiles/MidgarTile1,/area/Inside)
"ax" = (/turf/MidgarTiles/MidgarTile1,/area/Inside)
"ay" = (/obj/Turfs/Edges/MetalEdgeS,/turf/MidgarTiles/MidgarTile1,/area/Inside)
"az" = (/obj/Turfs/Edges/MetalEdgeS,/obj/Special/Teleporter2{gotoX = 121; gotoY = 195; gotoZ = 1},/turf/MidgarTiles/MidgarTile1,/area/Inside)
"aA" = (/obj/Turfs/Edges/MetalEdgeE,/turf/MidgarTiles/MidgarTile1,/area/Inside)
"aB" = (/obj/Turfs/Edges/DarkEdgeW,/obj/Turfs/Edges/DarkEdgeN,/obj/Turfs/Edges/MetalEdgeW,/obj/Turfs/Edges/MetalEdgeN,/turf/MidgarTiles/MidgarLightWall3,/area/Inside)
"aC" = (/obj/Turfs/Edges/DarkEdgeN,/obj/Turfs/Edges/MetalEdgeN,/turf/MidgarTiles/MidgarLightWall3,/area/Inside)
"aD" = (/obj/Turfs/Edges/DarkEdgeE,/obj/Turfs/Edges/DarkEdgeN,/obj/Turfs/Edges/MetalEdgeN,/turf/MidgarTiles/MidgarLightWall3,/area/Inside)
"aE" = (/obj/Turfs/Edges/DarkEdgeW,/obj/Turfs/Edges/MetalEdgeW,/turf/MidgarTiles/Midgarwall5,/area/Inside)
"aF" = (/obj/Turfs/Edges/DarkEdgeW,/obj/Turfs/Edges/MetalEdgeW,/turf/MidgarTiles/MidgarLightWall3,/area/Inside)
"aG" = (/turf/MidgarTiles/MidgarWall4,/obj/Turfs/Edges/DarkEdgeW,/obj/Turfs/Edges/MetalEdgeW,/turf/Special/Midgar_IchorWall,/area/Inside)
"aH" = (/obj/Turfs/Edges/MetalEdgeW,/turf/Special/Ichor_Water,/area/Inside)
"aI" = (/obj/Turfs/Edges/MetalEdgeE,/obj/Turfs/Edges/MetalEdgeN,/turf/MidgarTiles/MidgarTile1,/area/Inside)
"aJ" = (/obj/Turfs/Edges/MetalEdgeW,/obj/Turfs/Edges/MetalEdgeS,/turf/MidgarTiles/MidgarTile1,/area/Inside)
"aK" = (/obj/Turfs/Edges/DarkEdgeW,/obj/Turfs/Edges/DarkEdgeN,/obj/Turfs/Edges/MetalEdgeN,/turf/MidgarTiles/MidgarLightWall3,/area/Inside)
"aL" = (/obj/Turfs/Edges/DarkEdgeE,/obj/Turfs/Edges/DarkEdgeN,/obj/Turfs/Edges/MetalEdgeN,/obj/Turfs/Edges/MetalEdgeE,/turf/MidgarTiles/MidgarLightWall3,/area/Inside)
"aM" = (/obj/Turfs/Edges/DarkEdgeE,/obj/Turfs/Edges/MetalEdgeE,/turf/MidgarTiles/Midgarwall5,/area/Inside)
"aN" = (/obj/Turfs/Edges/DarkEdgeE,/obj/Turfs/Edges/MetalEdgeE,/turf/MidgarTiles/MidgarLightWall3,/area/Inside)
"aO" = (/turf/MidgarTiles/MidgarWall4,/obj/Turfs/Edges/DarkEdgeE,/obj/Turfs/Edges/MetalEdgeE,/turf/Special/Midgar_IchorWall,/area/Inside)
"aP" = (/turf/MidgarTiles/MidgarRoofSE,/area/Inside)
"aQ" = (/turf/MidgarTiles/MidgarRoofSW,/area/Inside)
"aR" = (/turf/MidgarTiles/MidgarRoofNE,/area/Inside)
"aS" = (/turf/MidgarTiles/MidgarRoofNW,/area/Inside)
"aT" = (/obj/Turfs/Edges/DarkEdgeE,/obj/Turfs/Edges/DarkEdgeN,/obj/Turfs/Edges/MetalEdgeE,/obj/Turfs/Edges/MetalEdgeN,/turf/MidgarTiles/MidgarLightWall3,/area/Inside)
"aU" = (/obj/Turfs/MidgarObj/MidgarLaser2,/turf/MidgarTiles/MidgarTile1,/area/Inside)
"aV" = (/obj/Turfs/MidgarObj/MidgarLaser4,/turf/MidgarTiles/MidgarTile1,/area/Inside)
"aW" = (/obj/Turfs/PipeNS,/turf/MidgarTiles/MidgarLightWall3,/area/Inside)
"aX" = (/turf/MidgarTiles/MidgarTile2,/area/Inside)
"aY" = (/turf/MidgarTiles/MidgarLightWall2,/area/Inside)
"aZ" = (/turf/MidgarTiles/MidgarLightWall3,/turf/MidgarTiles/MidgarLadder,/area/Inside)
"ba" = (/turf/MidgarTiles/MidgarWall4,/area/Inside)
"bb" = (/obj/Turfs/PipeNS,/turf/MidgarTiles/MidgarWall4,/area/Inside)
"bc" = (/obj/Turfs/MidgarObj/TV,/turf/MidgarTiles/MidgarWall4,/area/Inside)
"bd" = (/turf/MidgarTiles/MidgarRapeWindow,/area/Inside)
"be" = (/turf/MidgarTiles/MidgarWall4,/turf/MidgarTiles/MidgarLadder3,/turf/MidgarTiles/MidgarLadder,/area/Inside)
"bf" = (/obj/Turfs/PipeNS,/turf/MidgarTiles/MidgarTile1,/area/Inside)
"bg" = (/obj/Turfs/MidgarObj/MidgarBarrel,/turf/MidgarTiles/MidgarTile1,/area/Inside)
"bh" = (/turf/MidgarTiles/MidgarTile1,/turf/MidgarTiles/MidgarSlime2,/area/Inside)
"bi" = (/obj/Turfs/MidgarObj/Lampost,/turf/MidgarTiles/MidgarTile1,/area/Inside)
"bj" = (/obj/Turfs/MidgarObj/Midgarchest,/turf/MidgarTiles/MidgarTile1,/area/Inside)
"bk" = (/obj/Turfs/MidgarObj/MidgarCrane,/turf/MidgarTiles/MidgarTile1,/area/Inside)
"bl" = (/turf/MidgarTiles/MidgarTile1,/turf/MidgarTiles/MidgarSlime3,/area/Inside)
"bm" = (/turf/MidgarTiles/MidgarTile1,/turf/MidgarTiles/MidgarSlime4,/area/Inside)
"bn" = (/obj/Turfs/MidgarObj/MidgarBarrel,/obj/Turfs/PipeNS,/turf/MidgarTiles/MidgarTile1,/area/Inside)
"bo" = (/turf/MidgarTiles/MidgarSlime5,/area/Inside)
"bp" = (/turf/MidgarTiles/MidgarTile1,/turf/MidgarTiles/MidgarSlime,/area/Inside)
"bq" = (/obj/Turfs/Edges/MetalEdgeS,/obj/Turfs/Edges/MetalEdgeE,/turf/Special/Ichor_Water,/area/Inside)
"br" = (/obj/Turfs/Edges/MetalEdgeN,/turf/MidgarTiles/MidgarTile2,/area/Inside)
"bs" = (/obj/Turfs/Edges/MetalEdgeN,/turf/MidgarTiles/MidgarTile3,/area/Inside)
"bt" = (/obj/Turfs/Edges/MetalEdgeS,/turf/MidgarTiles/MidgarTile2,/area/Inside)
"bu" = (/obj/Turfs/Edges/MetalEdgeS,/turf/MidgarTiles/MidgarTile3,/area/Inside)
"bv" = (/obj/Turfs/Edges/MetalEdgeS,/obj/Turfs/Edges/MetalEdgeE,/turf/MidgarTiles/MidgarTile1,/area/Inside)
"bw" = (/obj/Turfs/MidgarObj/Midgarchest,/obj/Turfs/PipeNS,/turf/MidgarTiles/MidgarTile1,/area/Inside)
"bx" = (/obj/Turfs/PipeWE,/turf/MidgarTiles/MidgarTile1,/area/Inside)
"by" = (/obj/Turfs/PipeWE,/obj/Turfs/MidgarObj/Lampost,/turf/MidgarTiles/MidgarTile1,/area/Inside)
"bz" = (/obj/Turfs/PipeNS,/obj/Turfs/PipeWE,/turf/MidgarTiles/MidgarTile1,/area/Inside)
"bA" = (/turf/MidgarTiles/MidgarRapeWindow,/turf/Special/Midgar_IchorWall,/area/Inside)
"bB" = (/turf/MidgarTiles/MidgarTile4,/area/Inside)
"bC" = (/turf/MidgarTiles/MidgarTile3,/area/Inside)
"bD" = (/turf/MidgarTiles/MidgarTile4,/turf/Special/MidgarIchorW,/turf/Special/MidgarIchorN,/turf/Special/MidgarIchorS,/area/Inside)
"bE" = (/obj/Special/Teleporter2{gotoX = 211; gotoY = 86; gotoZ = 12},/turf/Special/Midgar_Ichor,/area/Inside)
"bF" = (/turf/Wood9,/area/Inside)
"bG" = (/turf/MidgarTiles/MidgarTile1,/turf/Special/MidgarIchorW,/turf/Special/MidgarIchorN,/area/Inside)
"bH" = (/turf/Special/Midgar_Ichor,/area/Inside)
"bI" = (/turf/MidgarTiles/MidgarTile1,/turf/Special/MidgarIchorW,/area/Inside)

(1,1,1) = {"
aaaaaaaaaaaaaaaaaaaaaaaaaaaaaaaaaaaaaaaaaaaaaaaaaaaaaaaaaaaaaaaaaaaaaaaaaaaaaaaaaaaaaaaaaaaaaaaaaaaaaaaaaaaaaaaaaaaaaaaaaaaaaaaaaaaaaaaaaaaaaaaaaaaaaaaaaaaaaaaaaa
ababababababababababababababababababababababababababababababababababababababababababababababababababababababababababababababababababababababababababababababababab
acadaeafafafafafafafafafafafafafafafafafafafafafafafafafafafafafafafafafafafafafafafafafafafafafafafafafafafafafafafafafafafafafafafafafafafafafafafafafafafagacad
acadahaiaiaiaiaiaiaiaiaiaiaiaiaiaiaiaiaiaiaiaiaiaiaiaiaiaiaiaiaiaiaiaiaiaiaiaiaiaiaiaiaiaiaiaiaiaiaiaiaiaiaiaiaiaiaiaiaiaiaiaiaiaiaiaiaiaiaiaiaiaiaiaiaiaiaiajacad
acadakalalalalalalalalalalalalalalalalalalalalalalalalalalalalalalalalalalalalalalalalalalalalalalalalalalalalalalalalalalalalalalalalalalalalalalalalalalalamacad
acadanaoaoaoaoaoaoaoaoaoaoaoaoaoaoaoaoaoaoaoaoaoaoaoaoaoaoaoaoaoaoaoaoaoaoaoaoaoaoaoaoaoaoaoaoaoaoaoaoaoaoaoaoaoaoaoaoaoaoaoaoaoaoaoaoaoaoaoaoaoaoaoaoaoaoaoapacad
acadaqaqaqaqaqaqaqaqaqaqaqaqaqaqaqaqaqaqaqaqaqaqaqaqaqaqaqaqaqaqaqaqaqaqaqaqaqaqaqaqaqaqaqaqaqaqaqaqaqaqaqaqaqaqaqaqaqaqaqaqaqaqaqaqaqaqaqaqaqaqaqaqaqaqaqaqaqacad
acadaqaqaqaqaqaqaqaqaqaqaqaqaqaqaqaqaqaqaqaqaqaqaqaqaqaqaqaqaqaqaqaqaqaqaqaqaqaqaqaqaqaqaqaqaqaqaqaqaqaqaqaqaqaqaqaqaqaqaqaqaqaqaqaqaqaqaqaqaqaqaqaqaqaqaqaqaqacad
acadaqaqaqaqaqaqaqaqaqaqaqaqaqaqaqaqaqaqaqaqaqaqaqaqaqaqaqaqaqaqaqaqaqaqaqaqaqaqaqaqaqaqaqaqaqaqaqaqaqaqaqaqaqaqaqaqaqaqaqaqaqaqaqaqaqaqaqaqaqaqaqaqaqaqaqaqaqacad
acadaqaqaqaqaqaqaqaqaqaqaqaqaqaqaqaqaqaqaqaqaqaqaqaqaqaqaqaqarararararararararararararararararararararararararararararararararararararararararararararararararacad
acadaqaqaqaqaqaqaqaqaqaqaqaqaqaqaqaqaqaqaqaqaqaqaqaqaqaqaqasatauauauauauauauauauauauauauauauauauauauauauauauauauauauauauauauauauauauauauauauauauauauauauauauavacad
acadaqaqaqaqaqaqaqaqaqaqaqaqaqaqaqaqaqaqaqaqaqaqaqaqaqaqaqasawaxayayayayayayayayayayayayayayayayayayayayayayayayayayayayayayayayayayayayayayayayayayayayayayazacad
acadaqaqaqaqaqaqaqaqaqaqaqaqaqaqaqaqaqaqaqaqaqaqaqaqaqaqaqasawaAaBaCaCaCaCaCaCaCaCaCaCaCaCaCaCaCaCaCaCaCaCaCaCaCaCaCaCaCaCaCaCaCaCaCaCaCaCaCaCaCaCaCaCaCaCaCaDacad
acadaqaqaqaqaqaqaqaqaqaqaqaqaqaqaqaqaqaqaqaqaqaqaqaqaqaqaqasawaAaEaiaiaiaiaiaiaiaiaiaiaiaiaiaiaiaiaiaiaiaiaiaiaiaiaiaiaiaiaiaiaiaiaiaiaiaiaiaiaiaiaiaiaiaiaiajacad
acadaqaqaqaqaqaqaqaqaqaqaqaqaqaqaqaqaqaqaqaqaqaqaqaqaqaqaqasawaAaFalalalalalalalalalalalalalalalalalalalalalalalalalalalalalalalalalalalalalalalalalalalalalamacad
acadaqaqaqaqaqaqaqaqaqaqaqaqaqaqaqaqaqaqaqaqaqaqaqaqaqaqaqasawaAaGaoaoaoaoaoaoaoaoaoaoaoaoaoaoaoaoaoaoaoaoaoaoaoaoaoaoaoaoaoaoaoaoaoaoaoaoaoaoaoaoaoaoaoaoaoapacad
acadaqaqaqaqaqaqaqaqaqaqaqaqaqaqaqaqaqaqaqaqaqaqaqaqaqaqaqasawaAaHaqaqaqaqaqaqaqaqaqaqaqaqaqaqaqaqaqaqaqaqaqaqaqaqaqaqaqaqaqaqaqaqaqaqaqaqaqaqaqaqaqaqaqaqaqaqacad
acadaqaqaqaqaqaqaqaqaqaqaqaqaqaqaqaqaqaqaqaqaqaqaqaqaqaqaqasawaxauauauauauauauauauauauauauauauauauauauauauauauauauaIaHaqaqaqaqaqaqaqaqaqaqaqaqaqaqaqaqaqaqaqaqacad
acadaqaqaqaqaqaqaqaqaqaqaqaqaqaqaqaqaqaqaqaqaqaqaqaqaqaqaqasaJayayayayayayayayayayayayayayayayayayayayayayayayayaxaAaHaqaqaqaqaqaqaqaqaqaqaqaqaqaqaqaqaqaqaqaqacad
acadaqaqaqaqaqaqaqaqaqaqaqaqaqaqaqaqaqaqaqaqaqaqaqaqaqaqaqaqaKaDaKaCaCaCaCaCaCaCaCaCaCaCaCaCaCaCaCaCaCaCaCaCaCaLawaAaHaqaqaqaqaqaqaqaqaqaqaqaqaqaqaqaqaqaqaqaqacad
acadaqaqaqaqaqaqaqaqaqaqaqaqaqaqaqaqaqaqaqaqaqaqaqaqaqaqaqaqahajahaiaiaiaiaiaiaiaiaiaiaiaiaiaiaiaiaiaiaiaiaiaiaMawaAaHaqaqaqaqaqaqaqaqaqaqaqaqaqaqaqaqaqaqaqaqacad
acadaqaqaqaqaqaqaqaqaqaqaqaqaqaqaqaqaqaqaqaqaqaqaqaqaqaqaqaqakamakalalalalalalalalalalalalalalalalalalalalalalaNawaAaHaqaqaqaqaqaqaqaqaqaqaqaqaqaqaqaqaqaqaqaqacad
acadaqaqaqaqaqaqaqaqaqaqaqaqaqaqaqaqaqaqaqaqaqaqaqaqaqaqaqaqanapanaoaoaoaoaoaoaoaoaoaoaoaoaoaoaoaoaoaoaoaoaoaoaOawaAaHaqaqaqaqaqaqaqaqaqaqaqaqaqaqaqaqaqaqaqaqacad
acadaqaqaqaqaqaqaqaqaqaqaqaqaqaqaqaqaqaqaqaqaqaqaqaqaqaqaqaqaqaqaqaqaqaqaqaqaqaqaqaqaqaqaqaqaqaqaqaqaqaqaqaqaqasawaAaHaqaqaqaqaqaqaqaqaqaqaqaqaqaqaqaqaqaqaqaqacad
acadaqaqaqaqaqaqaqaqaqaqaqaqaqaqaqaqaqaqaqaqaqaqaqaqaqaqaqaqaqaqaqaqaqaqaqaqaqaqaqaqaqaqaqaqaqaqaqaqaqaqaqaqaqasawaAaHaqaqaqaqaqaqaqaqaqaqaqaqaqaqaqaqaqaqaqaqacad
acadaqaqaqaqaqaqaqaqaqaqaqaqaqaqaqaqaqaqaqaqaqaqaqaqaqaqaqaqaqaqaqaqaqaqaqaqaqaqaqaqaqaqaqaqaqaqaqaqaqaqaqaqaqasawaAaHaqaqaqaqaqaqaqaqaqaqaqaqaqaqaqaqaqaqaqaqacad
acadaqaqaqaqaqaqaqaqaqaqaqaqaqaqaqaqaqaqaqaqaqaqaqaqaqaqaqaqaqaqaqaqaqaqaqaqaqaqaqaqaqaqaqaqaqaqaqaqaqaqaqaqaqasawaAaHaqaqaqaqaqaqaqaqaqaqaqaqaqaqaqaqaqaqaqaqacad
acadaqaqaqaqaqaqaqaqaqaqaqaqaqaqaqaqaqaqaqaqaqaqaqaqaqaqaqaqaqaqaqaqaqaqaqaqaqaqaqaqaqaqaqaqaqaqaqaqaqaqaqaqaqasawaAaHaqaqaqaqaqaqaqaqaqaqaqaqaqaqaqaqaqaqaqaqacad
acadaqaqaqaqaqaqaqaqaqaqaqaqaqaqaqaqaqaqaqaqaqaqaqaqaqaqaqaqaqaqaqaqaqaqaqaqaqaqaqaqaqaqaqaqaqaqaqaqaqaqaqaqaqasawaAaHaqaqaqaqaqaqaqaqaqaqaqaqaqaqaqaqaqaqaqaqacad
acadaqaqaqaqaqaqaqaqaqaqaqaqaqaqaqaqaqaqaqaqaqaqaqaqaqaqaqaqaqaqaqaqaqaqaqaqaqaqaqaqaqaqaqaqaqaqaqaqaqaqaqaqaqasawaAaHaqaqaqaqaqaqaqaqaqaqaqaqaqaqaqaqaqaqaqaqacad
acadaqaqaqaqaqaqaqaqaqaqaqaqaqaqaqaqaqaqaqaqaqaqaqaqaqaqaqaqaqaqaqaqaqaqaqaqaqaqaqaqaqaqaqaqaqaqaqaqaqaqaqaqaqasawaAaHaqaqaqaqaqaqaqaqaqaqaqaqaqaqaqaqaqaqaqaqacad
acadaqaqaqaqaqaqaqaqaqaqaqaqaqaqaqaqaqaqaqaqaqaqaqaqaqaqaqaqaqaqaqaqaqaqaqaqaqaqaqaqaqaqaqaqaqaqaqaqaqaqaqaqaqasawaAaHaqaqaqaqaqaqaqaqaqaqaqaqaqaqaqaqaqaqaqaqacad
acadaqaqaqaqaqaqaqaqaqaqaqaqaqaqaqaqaqaqaqaqaqaqaqaqaqaqaqaqaqaqaqaqaqaqaqaqaqaqaqaqaqaqaqaqaqaqaqaqaqaqaqaqaqasawaAaHaqaqaqaqaqaqaqaqaqaqaqaqaqaqaqaqaqaqaqaqacad
acadaqaqaqaqaqaqaqaqaqaqaqaqaqaqaqaqaqaqaqaqaqaqaqaqaqaqaqaqaqaqaqaqaqaqaqaqaqaqaqaqaqaqaqaqaqaqaqaqaqaqaqaqaqasawaAaHaqaqaqaqaqaqaqaqaqaqaqaqaqaqaqaqaqaqaqaqacad
acadaqaqaqaqaqaqaqaqaqaqaqaqaqaqaqaqaqaqaqaqaqaqaqaqaqaqaqaqaqaqaqaqaqaqaPaaaaaaaaaaaaaaaaaaaaaaaQaqaqaqaqaqaqasawaAaHaqaqaqaqaqaqaqaqaqaqaqaqaqaqaqaqaqaqaqaqacad
acadararararararararararararararararararararararararararararararararararacaRababababababababababaSaqaqaqaqaqaqasawaAaHaqaqaqaqaqaqaqaqaqaqaqaqaqaqaqaqaqaqaqaqacad
acadauauauauauauauauauauauauauauauauauauauauauauauauauauauauauauauauauauacaQaeafafafafafafafafafagaqaqaqaqaqaqasawaAaHaqaqaqaqaqaqaqaqaqaqaqaqaqaqaqaqaqaqaqaqacad
acadaxaxayayayayayayayayayayayayayayayayayayayaxaxayayayayayayayayayayayacadahaiaiaiaiaiaiaiaiaiajaqaqaqaqaqaqasawaAaHaqaqaqaqaqaqaqaqaqaqaqaqaqaqaqaqaqaqaqaqacad
acadaxaAaBaCaCaCaCaCaCaCaCaCaCaCaCaCaCaCaCaCaTawaAaBaCaCaCaCaCaCaCaCaCaDacadakalalalalalalalalalamaqaqaqaqaqaqasawaAaHaqaqaqaqaqaqaqaqaqaqaqaqaqaqaqaqaqaqaqaqacad
acadaxaAaEaiaiaiaiaiaiaiaiaiaiaiaiaiaiaiaiaiaMawaAaEaiaiaiaiaiaiaiaiaiajacadanaoaoaoaoaoaoaoaoaoapaqaqaqaqaqaqasawaAaHaqaqaqaqaqaqaqaqaqaqaqaqaqaqaqaqaqaqaqaqacad
acadaxaAaFalalalalalalalalalalalalalalalalalaNawaAaFalalalalalalalalalamacadaqaqaqaqaqaqaqaqaqaqaqaqaqaqaqaqaqasawaAaHaqaqaqaqaqaqaqaqaqaqaqaqaqaqaqaqaqaqaqaqacad
acadaxaAaGaoaoaoaoaoaoaoaoaoaoaoaoaoaoaoaoaoaOawaAaGaoaoaoaoaoaoaoaoaoapacadaqaqaqaqaqaqaqaqaqaqaqaqaqaqaqaqaqasawaAaHaqaqaqaqaqaqaqaqaqaqaqaqaqaqaqaqaqaqaqaqacad
acadaxaAaHaqaqaqaqaqaqaqaqaqaqaqaqaqaqaqaqaqasawaAaHaqaqaqaqaqaqaqaqaqaqacadaqaqaqaqaqaqaqaqaqaqaqaqaqaqaqaqaqasawaAaHaqaqaqaqaqaqaqaqaqaqaqaqaqaqaqaqaqaqaqaqacad
acadaxaAaHaqaqaqaqaqaqaqaqaqaqaqaqaqaqaqaqaqasawaAaHaqaqaqaqaqaqaqaqaqaqacadaqaqaqaqaqaqaqaqaqaqaqaqaqaqaqaqaqasawaAaHaqaqaqaqaqaqaqaqaqaqaqaqaqaqaqaqaqaqaqaqacad
acadaxaAaHaqaqaqaqaqaqaqaqaqaqaqaqaqaqaqaqaqasawaAaHaqaqaqaqaqaqaqaqaqaqaRaSaqaqaqaqaqaqaqaqaqaqaqaqaqaqaqaqaqasawaAaHaqaqaqaqaqaqaqaqaqaqaqaqaqaqaqaqaqaqaqaqacad
acadaxaAaHaqaqaqaqaqaPaaaaaaaaaaaaaaaaaaaaaaaQawaAaPaaaaaaaaaaaaaaaaaaaaaaaQaqaqaqaqaqaqaqaqaqaqaqaqaqaqaqaqaqasawaAaHaqaqaqaqaqaqaqaqaqaqaqaqaqaqaqaqaqaqaqaqacad
acadaxaAaHaqaqaqaqaqacaRababababababababababaSaUaVaRabababababababababaSaPadaqaqaqaqaqaqaqaqaqaqaqaqaqaqaqaqaqasawaAaHaqaqaqaqaqaqaqaqaqaqaqaqaqaqaqaqaqaqaqaqacad
acadaxaAaHaqaqaqaqaqacaQalalalalaWalalalalalalaXaXaYalaZalalalalalalalalacadaqaqaqaqaqaqaqaqaqaqaqaqaqaqaqaqaqasawaAaHaqaqaqaqaqaqaqaqaqaqaqaqaqaqaqaqaqaqaqaqacad
acadaxaAaHaqaqaqaqaqacadbababababbbababababcbdaxaxbdbcbebabababababababaacadaqaqaqaqaqaqaqaqaqaqaqaqaqaqaqaqaqasawaAaHaqaqaqaqaqaqaqaqaqaqaqaqaqaqaqaqaqaqaqaqacad
acadaxaAaHaqaqaqaqaqacadaxaxaxaxbfaxaxaxaxaxaxaxaxaxaxaxbgbgbgbgbgbgaxbhacadaqaqaqaqaqaqaqaqaqaqaqaqaqaqaqaqaqasawaAaHaqaqaqaqaqaqaqaqaqaqaqaqaqaqaqaqaqaqaqaqacad
acadaxaAaHaqaqaqaqaqacadaxbiaxaxbfaxaxbjaxaxaxaxaxaxaxaxaxbgbgbgaxaxbiaxacadaqaqaqaqaqaqaqaqaqaqaqaqaqaqaqaqaqasawaAaHaqaqaqaqaqaqaqaqaqaqaqaqaqaqaqaqaqaqaqaqacad
acadaxaAaHaqaqaqaqaqacadaxaxaxaxbfaxaxaxaxaxaxaxaxaxaxaxaxaxaxaxaxaxaxaxacadaqaqaqaqaqaqaqaqaqaqaqaqaqaqaqaqaqasawaAaHaqaqaqaqaqaqaqaqaqaqaqaqaqaqaqaqaqaqaqaqacad
acadaxaAaHaqaqaqaqaqacadaxaxaxaxbfaxaxaxaxaxaxaxaxaxaxaxaxaxaxaxaxaxaxaxacadaqaqaqaqaqaqaqaqaqaqaqaqaqaqaqaqaqasawaAaHaqaqaqaqaqaqaqaqaqaqaqaqaqaqaqaqaqaqaqaqacad
acadaxaAaHaqaqaqaqaqacadaxaxaxaxbfaxbkaxaxaxaxaxaxaxaxaxaxaxaxaxaxaxaxaxacadaqaqaqaqaqaqaqaqaqaqaqaqaqaqaqaqaqasawaAaHaqaqaqaqaqaqaqaqaqaqaqaqaqaqaqaqaqaqaqaqacad
acadaxaAaHaqaqaqaqaqacadaxaxaxaxbfaxaxaxaxaxaxaxaxblbmaxaxaxaxaxaxaxaxaxacadaqaqaqaqaqaqaqaqaqaqaqaqaqaqaqaqaqasawaAaHaqaqaqaqaqaqaqaqaqaqaqaqaqaqaqaqaqaqaqaqacad
acadaxaAaHaqaqaqaqaqacadaxaxaxaxbnaxaxaxaxaxaxblbobobpaxaxaxaxbkaxaxbjaxacadaqaqaqaqaqaqaqaqaqaqaqaqaqaqaqaqaqasawaAaHaqaqaqaqaqaqaqaqaqaqaqaqaqaqaqaqaqaqaqaqacad
acadaxaAaHaqaqaqaqaqacadaxaxaxaxbnbgaxaxaxaxblbobobobmaxaxaxaxaxaxaxaxaxacadaqaqaqaqaqaqaqaqaqaqaqaqaqaqaqaqaqasawaAaHaqaqaqaqaqaqaqaqaqaqaqaqaqaqaqaqaqaqaqaqacad
acadaxaAaHaqaqaqaqaqacadaxaxaxbgbnbgaxaxaxaxbhbobobobpaxaxaxaxaxaxaxaxaxacadaqaqaqaqaqaqaqaqaqaqaqaqaqaqaqaqaqasawaAaHaqaqaqaqaqaqaqaqaqaqaqaqaqaqaqaqaqaqaqaqacad
acadaxaAaHaqaqaqaqaqacadaxaxaxbgbnbgaxaxaxaxaxbhbpaxaxaxaxaxaxaxaxaxaxaxaRaSaqaqaqaqaqaqaqaqaqaqaqaqaqaqaqaqaqasawaAaHaqaqaqaqaqaqaqaqaqaqaqaqaqaqaqaqaqaqaqaqacad
acadaxaAaHaqaqaqaqaqacadaxaxaxbgbnbgaxaxaxaxaxaxaxaxaxaxaxaxaxaxaxaxaxaxalalaqaqaqaqaqaqaqaqaqaqaqaqaqaqaqaqaqasawaAaHaqaqaqaqaqaqaqaqaqaqaqaqaqaqaqaqaqaqaqaqacad
acadaxaAaHaqaqaqaqaqacadaxaxaxaxbnaxaxaxaxaxaxaxaxaxaxaxaxaxaxaxaxaxaxaxbdbdarararararararararararararararararbqawaAaHaqaqaqaqaqaqaqaqaqaqaqaqaqaqaqaqaqaqaqaqacad
acadaxaAaHaqaqaqaqaqacadaxaxaxaxbfaxaxaxaxaxaxaxaxaxaxaxaxaxaxaxaxaxaxaxaxbrbsauauauauauauauauauauauauauauauauauaxaAaHaqaqaqaqaqaqaqaqaqaqaqaqaqaqaqaqaqaqaqaqacad
acadaxaAaHaqaqaqaqaqacadaxaxaxaxbfaxaxaxaxaxaxaxaxaxaxaxaxaxaxaxaxaxaxaxaxbtbuayayayayayayayayayayayayayayayayayaybvaHaqaqaqaqaqaqaqaqaqaqaqaqaqaqaqaqaqaqaqaqacad
acadaxaAaHaqaqaqaqaqacadaxaxaxaxbfaxaxaxaxaxaxaxaxaxbgbgbgbgbgaxaxaxaxaxaPaQaKaCaCaCaCaCaCaCaCaCaCaCaCaCaCaCaCaCaCaDaqaqaqaqaqaqaqaqaqaqaqaqaqaqaqaqaqaqaqaqaqacad
acadaxaAaHaqaqaqaqaqacadaxbjbjbjbfaxaxaxaxaxaxaxaxbgbgbgbgbgbgbgaxaxaxaxacadahaiaiaiaiaiaiaiaiaiaiaiaiaiaiaiaiaiaiajaqaqaqaqaqaqaqaqaqaqaqaqaqaqaqaqaqaqaqaqaqacad
acadaxaAaHaqaqaqaqaqacadaxbgbjbjbwaxaxbjaxaxaxaxbgbgbgbgbgbgbgbgaxaxaxaxacadakalalalalalalalalalalalalalalalalalalamaqaqaqaqaqaqaqaqaqaqaqaqaqaqaqaqaqaqaqaqaqacad
acadaxaAaHaqaqaqaqaqacadaxaxaxaxbfaxaxaxaxaxaxbgbgbgbgbgbgaxaxaxaxaxaxaxacadanaoaoaoaoaoaoaoaoaoaoaoaoaoaoaoaoaoaoapaqaqaqaqaqaqaqaqaqaqaqaqaqaqaqaqaqaqaqaqaqacad
acadaxaAaHaqaqaqaqaqacadbxbybxbxbzbxbxbxbxbxbxbxbxbxbxbxbxbxbxbxbxbxbybxacadaqaqaqaqaqaqaqaqaqaqaqaqaqaqaqaqaqaqaqaqaqaqaqaqaqaqaqaqaqaqaqaqaqaqaqaqaqaqaqaqaqacad
acadaxaAaHaqaqaqaqaqacaSaxaxaxaxbfaxaxaxaxaxaxaxaxaxaxaxaxaxaxaxaxaxaxaxacadaqaqaqaqaqaqaqaqaqaqaqaqaqaqaqaqaqaqaqaqaqaqaqaqaqaqaqaqaqaqaqaqaqaqaqaqaqaqaqaqaqacad
acadaxaAaHaqaqaqaqaqacaPaaaaaaaaaaaaaaaaaaaaaaaaaaaaaaaaaaaaaaaaaaaaaaaQaRadaqaqaqaqaqaqaqaqaqaqaqaqaqaqaqaqaqaqaqaqaqaqaqaqaqaqaqaqaqaqaqaqaqaqaqaqaqaqaqaqaqacad
acadaxaAaHaqaqaqaqaqaRababababababababababababababababababababababababababaSaqaqaqaqaqaqaqaqaqaqaqaqaqaqaqaqaqaqaqaqaqaqaqaqaqaqaqaqaqaqaqaqaqaqaqaqaqaqaqaqaqacad
acadaxaAaHaqaqaqaqaqaeagafafafafafafafafafafafafafafafafafafafafafafafagaeagaqaqaqaqaqaqaqaqaqaqaqaqaqaqaqaqaqaqaqaqaqaqaqaqaqaqaqaqaqaqaqaqaqaqaqaqaqaqaqaqaqacad
acadaxaAaHaqaqaqaqaqahajaiaiaiaiaiaiaiaiaiaiaiaiaiaiaiaiaiaiaiaiaiaiaiajahajaqaqaqaqaqaqaqaqaqaqaqaqaqaqaqaqaqaqaqaqaqaqaqaqaqaqaqaqaqaqaqaqaqaqaqaqaqaqaqaqaqacad
acadaxaAaHaqaqaqaqaqakamalalalalalalalalalalalalalalalalalalalalalalalamakamaqaqaqaqaqaqaqaqaqaqaqaqaqaqaqaqaqaqaqaqaqaqaqaqaqaqaqaqaqaqaqaqaqaqaqaqaqaqaqaqaqacad
acadaxaAaHaqaqaqaqaqanapaoaoaoaoaoaoaoaoaoaoaoaoaoaoaoaoaoaoaoaoaoaoaoapanapaqaqaqaqaqaqaqaqaqaqaqaqaqaqaqaqaqaqaqaqaqaqaqaqaqaqaqaqaqaqaqaqaqaqaqaqaqaqaqaqaqacad
acadaxaAaHaqaqaqaqaqaqaqaqaqaqaqaqaqaqaqaqaqaqaqaqaqaqaqaqaqaqaqaqaqaqaqaqaqaqaqaqaqaqaqaqaqaqaqaqaqaqaqaqaqaqaqaqaqaqaqaqaqaqaqaqaqaqaqaqaqaqaqaqaqaqaqaqaqaqacad
acadaxaAaHaqaqaqaqaqaqaqaqaqaqaqaqaqaqaqaqaqaqaqaqaqaqaqaqaqaqaqaqaqaqaqaqaqaqaqaqaqaqaqaqaqaqaqaqaqaqaqaqaqaqaqaqaqaqaqaqaqaqaqaqaqaqaqaqaqaqaqaqaqaqaqaqaqaqacad
acadaxaAaHaqaqaqaqaqaqaqaqaqaqaqaqaqaqaqaqaqaqaqaqaqaqaqaqaqaqaqaqaqaqaqaqaqaqaqaqaqaqaqaqaqaqaqaqaqaqaqaqaqaqaqaqaqaqaqaqaqaqaqaqaqaqaqaqaqaqaqaqaqaqaqaqaqaqacad
acadaxaAaHaqaqaqaqaqaqaqaqaqaqaqaqaqaqaqaqaqaqaqaqaqaqaqaqaqaqaqaqaqaqaqaqaqaqaqaqaqaqaqaqaqaqaqaqaqaqaqaqaqaqaqaqaqaqaqaqaqaqaqaqaqaqaqaqaqaqaqaqaqaqaqaqaqaqacad
acadaxaAaHaqaqaqaqaqaqaqaqaqaqaqaqaqaqaqaqaqaqaqaqaqaqaqaqaqaqaqaqaqaqaqaqaqaqaqaqaqaqaqaqaqaqaqaqaqaqaqaqaqaqaqaqaqaqaqaqaqaqaqaqaqaqaqaqaqaqaqaqaqaqaqaqaqaqacad
acadaxaAaHaqaqaqaqaqaqaqaqaqaqaqaqaqaqaqaqaqaqaqaqaqaqaqaqaqaqaqaqaqaqaqaqaqaqaqaqaqaqaqaqaqaqaqaqaqaqaqaqaqaqaqaqaqaqaqaqaqaqaqaqaqaqaqaqaqaqaqaqaqaqaqaqaqaqacad
acadaxaAaHaqaqaqaqaqaqaqaqaqaPaaaaaaaaaaaaaaaaaaaaaaaaaaaaaaaaaaaaaaaaaaaaaaaaaaaaaaaaaaaaaaaaaaaaaaaaaaaaaaaaaaaaaaaaaaaaaaaaaaaaaaaaaaaaaaaaaaaaaaaaaaaaaaaQacad
acadaxaAaHaqaqaqaqaqaqaqaqaqaRabababababababababababababababababababababababababababababababababababababababababababababababababababababababababababababababaSacad
acadaxaAaHaqaqaqaqaqaqaqaqaqbdbdbdbdbdbdbdbdbdbdbdbdbdbdbdbdbdbdbdbdbdbdbdbdbdbdbdbdbdbdbdbdbdbdbdbdbdbdbdbdbdbdbdbdbdbdbdbdbdbdbdbdbdbdbdbdbdbdbdbdbdbdbdbAbAacad
acadaxbBaqaqaqaqaqaqaqaqaqaqbCaxaxaxaxaxaxaxaxaxbBaXbCaxaxaxaxaxaxaxaxaxaxaxaxaxaxaxaxaxaxaxaxaxaxaxaxaxbBaXbCaxaxaxaxaxaxaxaxaxaxaxaxaxaxaxaxaxaxaxaxaxaxbDbEacad
acadaxbFbFbFbFbFbFbFbFbFbFbFbFaxaxaxaxaxaxaxaxaxbBaXbCaxaxaxaxaxaxaxaxaxaxaxaxaxaxaxaxaxaxaxaxaxaxaxaxaxbBaXbCaxaxaxaxaxaxaxaxaxaxaxaxaxaxaxaxaxaxaxaxaxbGbHbEacad
acadaxbBaqaqaqaqaqaqaqaqaqaqbCaxaxaxaxaxaxaxaxaxbBaXbCaxaxaxaxaxaxaxaxaxaxaxaxaxaxaxaxaxaxaxaxaxaxaxaxaxbBaXbCaxaxaxaxaxaxaxaxaxaxaxaxaxaxaxaxaxaxaxaxbIbHbHbHacad
acadaeagaqaqaqaqaqaqaqaqaqaqafafafafafafafafafafafafafafafafafafafafafafafafafafafafafafafafafafafafafafafafafafafafafafafafafafafafafafafafafafafafafafafafagacad
acadahajaqaqaqaqaqaqaqaqaqaqaiaiaiaiaiaiaiaiaiaiaiaiaiaiaiaiaiaiaiaiaiaiaiaiaiaiaiaiaiaiaiaiaiaiaiaiaiaiaiaiaiaiaiaiaiaiaiaiaiaiaiaiaiaiaiaiaiaiaiaiaiaiaiaiajacad
acadakamaqaqaqaqaqaqaqaqaqaqalalalalalalalalalalalalalalalalalalalalalalalalalalalalalalalalalalalalalalalalalalalalalalalalalalalalalalalalalalalalalalalalamacad
acadanapaqaqaqaqaqaqaqaqaqaqaoaoaoaoaoaoaoaoaoaoaoaoaoaoaoaoaoaoaoaoaoaoaoaoaoaoaoaoaoaoaoaoaoaoaoaoaoaoaoaoaoaoaoaoaoaoaoaoaoaoaoaoaoaoaoaoaoaoaoaoaoaoaoaoapacad
acadaqaqaqaqaqaqaqaqaqaqaqaqaqaqaqaqaqaqaqaqaqaqaqaqaqaqaqaqaqaqaqaqaqaqaqaqaqaqaqaqaqaqaqaqaqaqaqaqaqaqaqaqaqaqaqaqaqaqaqaqaqaqaqaqaqaqaqaqaqaqaqaqaqaqaqaqaqacad
aaaaaaaaaaaaaaaaaaaaaaaaaaaaaaaaaaaaaaaaaaaaaaaaaaaaaaaaaaaaaaaaaaaaaaaaaaaaaaaaaaaaaaaaaaaaaaaaaaaaaaaaaaaaaaaaaaaaaaaaaaaaaaaaaaaaaaaaaaaaaaaaaaaaaaaaaaaaaaaaaa
ababababababababababababababababababababababababababababababababababababababababababababababababababababababababababababababababababababababababababababababababab
"}
