"a" = (/turf/Special/Blank,/area)

(1,1,1) = {"
a
"}
